,Player,Span,Mat,Inns,Dis,Ct,St,Ct Wk,Ct Fi,MD,D/I,Unnamed: 11
0,KC Sangakkara (Asia/ICC/SL),2000-2015,386,386,494,395,99,376,19,5 (4ct 1st),1.279,
1,AC Gilchrist (AUS/ICC),1996-2008,280,280,467,412,55,412,0,6 (6ct 0st),1.667,
2,MS Dhoni (Asia/INDIA),2004-2019,335,335,434,313,121,313,0,6 (5ct 1st),1.295,
3,MV Boucher (Afr/SA),1998-2011,286,286,417,395,22,394,1,6 (6ct 0st),1.458,
4,Moin Khan (PAK),1990-2004,216,216,286,213,73,213,0,5 (5ct 0st),1.324,
5,BB McCullum (NZ),2002-2016,245,245,268,253,15,220,33,5 (5ct 0st),1.093,
6,IA Healy (AUS),1988-1997,167,167,232,193,39,193,0,4 (4ct 0st),1.389,
7,Mushfiqur Rahim (BAN),2006-2021,222,222,231,185,46,183,2,5 (5ct 0st),1.04,
8,Rashid Latif (PAK),1992-2003,163,163,220,182,38,182,0,5 (5ct 0st),1.349,
9,DPMD Jayawardene (Asia/SL),1998-2015,430,430,215,215,0,0,215,4 (4ct 0st),0.5,
10,JC Buttler (ENG),2012-2021,142,142,210,178,32,178,0,6 (6ct 0st),1.478,
11,RS Kaluwitharana (SL),1990-2004,184,184,206,131,75,130,1,5 (4ct 1st),1.119,
12,PJL Dujon (WI),1981-1991,166,166,203,182,21,182,0,4 (4ct 0st),1.222,
13,R Dravid (Asia/ICC/INDIA),1996-2011,327,327,202,188,14,70,118,4 (4ct 0st),0.617,
14,Kamran Akmal (PAK),2002-2017,153,153,186,155,31,154,1,5 (4ct 1st),1.215,
15,Q de Kock (SA),2013-2022,122,122,184,173,11,173,0,6 (5ct 1st),1.508,
16,RD Jacobs (WI),1996-2004,138,138,183,154,29,154,0,6 (5ct 1st),1.326,
17,D Ramdin (WI),2005-2016,133,133,181,175,6,175,0,5 (5ct 0st),1.36,
18,AB de Villiers (Afr/SA),2005-2018,221,221,180,175,5,93,82,5 (5ct 0st),0.814,
19,BJ Haddin (AUS),2001-2015,117,117,179,168,11,168,0,5 (5ct 0st),1.529,
20,A Flower (ZIM),1992-2003,207,207,171,140,31,132,8,5 (5ct 0st),0.826,
21,AJ Stewart (ENG),1989-2003,164,164,169,154,15,145,9,6 (6ct 0st),1.03,
22,DJ Richardson (SA),1991-1998,119,119,164,147,17,147,0,5 (5ct 0st),1.378,
23,BRM Taylor (ZIM),2004-2021,203,203,159,130,29,100,30,5 (5ct 0st),0.783,
24,RT Ponting (AUS/ICC),1995-2012,363,363,157,157,0,0,157,3 (3ct 0st),0.432,
25,M Azharuddin (INDIA),1985-2000,320,320,154,154,0,0,154,4 (4ct 0st),0.481,
26,NR Mongia (INDIA),1994-2000,132,132,148,106,42,106,0,5 (4ct 1st),1.121,
27,T Taibu (ZIM),2001-2012,145,145,146,113,33,111,2,4 (4ct 0st),1.006,
28,Sarfaraz Ahmed (PAK),2007-2021,113,113,143,119,24,119,0,6 (6ct 0st),1.265,
29,LRPL Taylor (NZ),2006-2021,218,218,135,135,0,0,135,4 (4ct 0st),0.619,
30,Younis Khan (PAK),2000-2015,258,258,135,135,0,5,130,4 (4ct 0st),0.523,
31,V Kohli (INDIA),2008-2022,249,249,134,134,0,0,134,3 (3ct 0st),0.538,
32,SR Tendulkar (INDIA),1989-2012,439,439,134,134,0,0,134,4 (4ct 0st),0.305,
33,SP Fleming (ICC/NZ),1994-2007,265,265,132,132,0,0,132,4 (4ct 0st),0.498,
34,AC Parore (NZ),1992-2002,168,168,131,110,21,105,5,4 (4ct 0st),0.779,
35,JH Kallis (Afr/ICC/SA),1996-2014,318,318,130,130,0,0,130,3 (3ct 0st),0.408,
36,M Muralitharan (Asia/ICC/SL),1993-2011,337,337,129,129,0,0,129,3 (3ct 0st),0.382,
37,AR Border (AUS),1979-1994,262,262,126,126,0,0,126,3 (3ct 0st),0.48,
38,Khaled Mashud (BAN),1995-2006,124,124,126,91,35,91,0,5 (3ct 2st),1.016,
39,Shahid Afridi (Asia/ICC/PAK),1996-2015,389,389,126,126,0,0,126,2 (2ct 0st),0.323,
40,TM Dilshan (SL),1999-2016,314,314,123,122,1,5,117,3 (3ct 0st),0.391,
41,ST Jayasuriya (Asia/SL),1989-2011,429,429,122,122,0,0,122,3 (3ct 0st),0.284,
42,RW Marsh (AUS),1971-1984,89,89,122,118,4,118,0,5 (5ct 0st),1.37,
43,CL Hooper (WI),1987-2003,220,220,119,119,0,0,119,4 (4ct 0st),0.54,
44,BC Lara (ICC/WI),1990-2007,286,286,119,119,0,0,119,3 (3ct 0st),0.416,
45,MS Wade (AUS),2012-2021,90,90,115,106,9,106,0,5 (5ct 0st),1.277,
46,CH Gayle (ICC/WI),1999-2019,281,281,114,114,0,0,114,3 (3ct 0st),0.405,
47,Inzamam-ul-Haq (Asia/PAK),1991-2007,369,369,113,113,0,0,113,3 (3ct 0st),0.306,
48,L Ronchi (AUS/NZ),2008-2017,79,79,113,101,12,101,0,4 (4ct 0st),1.43,
49,ME Waugh (AUS),1988-2002,242,242,108,108,0,0,108,3 (3ct 0st),0.446,
0,SR Waugh (AUS),1986-2002,321,321,108,108,0,0,108,3 (3ct 0st),0.336,
1,SM Pollock (Afr/ICC/SA),1996-2008,293,293,107,107,0,0,107,2 (2ct 0st),0.365,
2,PD Collingwood (ENG),2001-2011,190,190,105,105,0,0,105,3 (3ct 0st),0.552,
3,HH Gibbs (SA),1996-2010,241,241,105,105,0,0,105,3 (3ct 0st),0.435,
4,RS Mahanama (SL),1986-1999,203,203,105,105,0,0,105,3 (3ct 0st),0.517,
5,GC Smith (SA),2002-2013,190,190,105,105,0,0,105,4 (4ct 0st),0.552,
6,MJ Clarke (AUS),2003-2015,232,232,103,103,0,0,103,4 (4ct 0st),0.443,
7,MEK Hussey (AUS),2004-2012,179,179,103,103,0,0,103,3 (3ct 0st),0.575,
8,JN Rhodes (SA),1992-2003,240,240,103,103,0,0,103,5 (5ct 0st),0.429,
9,Saleem Yousuf (PAK),1982-1990,86,86,103,81,22,81,0,4 (3ct 1st),1.197,
10,SD Hope (WI),2016-2022,80,80,100,90,10,90,0,5 (4ct 1st),1.25,
11,NJ O'Brien (IRE),2006-2018,97,97,100,86,14,78,8,5 (5ct 0st),1.03,
12,IVA Richards (WI),1975-1991,184,184,100,100,0,0,100,3 (3ct 0st),0.543,
13,SK Raina (INDIA),2005-2018,217,217,97,97,0,0,97,3 (3ct 0st),0.447,
14,SC Ganguly (Asia/INDIA),1992-2007,295,295,96,96,0,0,96,3 (3ct 0st),0.325,
15,Shoaib Malik (PAK),1999-2019,281,281,96,96,0,0,96,2 (2ct 0st),0.341,
16,HP Tillakaratne (SL),1986-2003,193,193,95,89,6,39,50,5 (5ct 0st),0.492,
17,PA de Silva (SL),1984-2003,295,295,94,94,0,0,94,3 (3ct 0st),0.318,
18,MJ Guptill (NZ),2009-2021,177,177,93,93,0,0,93,4 (4ct 0st),0.525,
19,TWM Latham (NZ),2012-2021,97,97,93,85,8,59,26,5 (5ct 0st),0.958,
20,CZ Harris (NZ),1990-2004,236,236,92,92,0,0,92,4 (4ct 0st),0.389,
21,Yuvraj Singh (Asia/INDIA),2000-2017,289,289,92,92,0,0,92,3 (3ct 0st),0.318,
22,Ijaz Ahmed (PAK),1986-2000,248,248,90,90,0,0,90,3 (3ct 0st),0.362,
23,KS More (INDIA),1984-1993,92,92,90,63,27,63,0,5 (3ct 2st),0.978,
24,Umar Akmal (PAK),2009-2019,119,119,90,77,13,45,32,5 (5ct 0st),0.756,
25,Mohammad Shahzad (AFG),2009-2019,83,83,89,64,25,63,1,5 (4ct 1st),1.072,
26,V Sehwag (Asia/ICC/INDIA),1999-2013,237,237,88,88,0,0,88,3 (3ct 0st),0.371,
27,Wasim Akram (PAK),1984-2003,350,350,88,88,0,0,88,3 (3ct 0st),0.251,
28,HM Amla (SA),2008-2019,175,175,87,87,0,0,87,4 (4ct 0st),0.497,
29,EJG Morgan (ENG/IRE),2006-2021,235,235,87,87,0,3,84,3 (3ct 0st),0.37,
30,MH Cross (SCOT),2014-2021,54,54,85,81,4,81,0,6 (6ct 0st),1.574,
31,DL Vettori (ICC/NZ),1997-2015,274,274,85,85,0,0,85,2 (2ct 0st),0.31,
32,Mohammad Hafeez (PAK),2003-2019,213,213,84,84,0,0,84,2 (2ct 0st),0.394,
33,A Kumble (Asia/INDIA),1990-2007,259,259,83,83,0,0,83,2 (2ct 0st),0.32,
34,JP Duminy (SA),2004-2019,194,194,82,82,0,0,82,3 (3ct 0st),0.422,
35,GW Flower (ZIM),1992-2010,213,213,82,82,0,0,82,2 (2ct 0st),0.384,
36,IDS Smith (NZ),1980-1992,95,95,82,78,4,77,1,3 (3ct 0st),0.863,
37,A Symonds (AUS),1998-2009,191,191,82,82,0,0,82,4 (4ct 0st),0.429,
38,GC Wilson (IRE),2007-2019,100,100,82,72,10,49,23,4 (4ct 0st),0.82,
39,NJ Astle (NZ),1995-2007,211,211,81,81,0,0,81,3 (3ct 0st),0.383,
40,F du Plessis (SA),2011-2019,140,140,81,81,0,0,81,3 (3ct 0st),0.578,
41,Saleem Malik (PAK),1982-1999,276,276,81,81,0,1,80,4 (4ct 0st),0.293,
42,UDU Chandana (SL),1994-2007,143,143,79,79,0,0,79,3 (3ct 0st),0.552,
43,SK Warne (AUS/ICC),1993-2005,192,192,79,79,0,0,79,3 (3ct 0st),0.411,
44,MJ Prior (ENG),2004-2011,66,66,77,69,8,67,2,6 (6ct 0st),1.166,
45,JE Root (ENG),2013-2021,144,144,76,76,0,0,76,3 (3ct 0st),0.527,
46,RG Sharma (INDIA),2007-2021,220,220,76,76,0,0,76,3 (3ct 0st),0.345,
47,RB Richardson (WI),1983-1996,219,219,75,75,0,0,75,4 (4ct 0st),0.342,
48,ADR Campbell (ZIM),1992-2003,183,183,74,74,0,2,72,3 (3ct 0st),0.404,
49,JC Adams (WI),1992-2001,123,123,73,68,5,26,42,5 (4ct 1st),0.593,
0,DJ Bravo (WI),2004-2014,158,158,73,73,0,0,73,3 (3ct 0st),0.462,
1,WJ Cronje (SA),1992-2000,183,183,73,73,0,0,73,2 (2ct 0st),0.398,
2,Javed Miandad (PAK),1975-1996,226,226,73,71,2,1,70,3 (3ct 0st),0.323,
3,S Chanderpaul (WI),1994-2011,255,255,72,72,0,0,72,2 (2ct 0st),0.282,
4,E Chigumbura (Afr/ZIM),2004-2018,211,211,72,72,0,0,72,4 (4ct 0st),0.341,
5,KD Karthik (INDIA),2004-2019,91,91,71,64,7,35,29,4 (4ct 0st),0.78,
6,H Masakadza (ZIM),2001-2019,208,208,71,71,0,0,71,2 (2ct 0st),0.341,
7,SB Styris (NZ),1999-2011,177,177,71,71,0,0,71,3 (3ct 0st),0.401,
8,MS Atapattu (SL),1990-2007,261,261,70,70,0,0,70,3 (3ct 0st),0.268,
9,S Dhawan (INDIA),2010-2022,143,143,70,70,0,0,70,4 (4ct 0st),0.489,
10,MG Bevan (AUS),1994-2004,229,229,69,69,0,0,69,3 (3ct 0st),0.301,
11,N Kapil Dev (INDIA),1978-1994,218,218,69,69,0,0,69,3 (3ct 0st),0.316,
12,Mahmudullah (BAN),2007-2021,195,195,69,69,0,0,69,3 (3ct 0st),0.353,
13,A Bagai (CAN),2003-2013,61,61,68,59,9,58,1,4 (4ct 0st),1.114,
14,Harbhajan Singh (Asia/INDIA),1998-2015,221,221,68,68,0,0,68,3 (3ct 0st),0.307,
15,DR Martyn (AUS),1992-2006,201,201,68,68,0,0,68,3 (3ct 0st),0.338,
16,ML Hayden (AUS/ICC),1993-2008,153,153,67,67,0,0,67,2 (2ct 0st),0.437,
17,GO Jones (ENG/PNG),2004-2014,49,49,67,63,4,63,0,5 (5ct 0st),1.367,
18,GJ Maxwell (AUS),2012-2020,110,110,67,67,0,0,67,4 (4ct 0st),0.609,
19,KJ O'Brien (IRE),2006-2021,146,146,67,67,0,0,67,3 (3ct 0st),0.458,
20,SPD Smith (AUS),2010-2020,122,122,67,67,0,0,67,3 (3ct 0st),0.549,
21,SO Tikolo (Afr/KENYA),1996-2014,131,131,67,67,0,0,67,3 (3ct 0st),0.511,
22,CO Browne (WI),1995-2005,45,45,66,57,9,57,0,5 (5ct 0st),1.466,
23,LD Chandimal (SL),2010-2022,144,144,66,58,8,30,28,4 (3ct 1st),0.458,
24,Misbah-ul-Haq (PAK),2002-2015,159,159,66,66,0,0,66,4 (4ct 0st),0.415,
25,WTS Porterfield (IRE),2006-2022,138,138,66,66,0,0,66,3 (3ct 0st),0.478,
26,DJG Sammy (WI),2004-2015,121,121,66,66,0,0,66,3 (3ct 0st),0.545,
27,CL Cairns (ICC/NZ),1991-2006,207,207,65,65,0,0,65,3 (3ct 0st),0.314,
28,MD Crowe (NZ),1982-1995,139,139,65,65,0,0,65,3 (3ct 0st),0.467,
29,GA Hick (ENG),1991-2001,117,117,62,62,0,0,62,3 (3ct 0st),0.529,
30,C Kieswetter (ENG),2010-2013,44,44,62,50,12,49,1,5 (2ct 3st),1.409,
31,Mashrafe Mortaza (Asia/BAN),2001-2020,217,217,62,62,0,0,62,2 (2ct 0st),0.285,
32,DA Miller (SA),2010-2022,134,134,62,62,0,0,62,3 (3ct 0st),0.462,
33,Wasim Bari (PAK),1973-1984,49,49,62,52,10,52,0,4 (3ct 1st),1.265,
34,SR Watson (AUS),2002-2015,181,181,62,62,0,0,62,2 (2ct 0st),0.342,
35,DJ Cullinan (SA),1993-2000,132,132,61,61,0,0,61,3 (3ct 0st),0.462,
36,AJ Finch (AUS),2013-2020,126,126,61,61,0,0,61,3 (3ct 0st),0.484,
37,NLTC Perera (SL),2009-2021,157,157,61,61,0,0,61,2 (2ct 0st),0.388,
38,KA Pollard (WI),2007-2022,118,118,61,61,0,0,61,4 (4ct 0st),0.516,
39,A Ranatunga (SL),1982-1999,256,256,61,61,0,0,61,3 (3ct 0st),0.238,
40,Tamim Iqbal (BAN),2007-2021,215,215,61,61,0,0,61,3 (3ct 0st),0.283,
41,RA Jadeja (INDIA),2009-2020,163,163,60,60,0,0,60,2 (2ct 0st),0.368,
42,G Kirsten (SA),1993-2003,181,181,60,59,1,1,58,3 (3ct 0st),0.331,
43,AL Logie (WI),1981-1993,157,157,60,60,0,0,60,3 (3ct 0st),0.382,
44,KS Williamson (NZ),2010-2020,146,146,60,60,0,0,60,3 (3ct 0st),0.41,
45,DL Haynes (WI),1978-1994,234,234,59,59,0,0,59,2 (2ct 0st),0.252,
46,WPUJC Vaas (Asia/SL),1994-2008,311,311,59,59,0,0,59,2 (2ct 0st),0.189,
47,A Jadeja (INDIA),1992-2000,186,186,58,58,0,0,58,2 (2ct 0st),0.311,
48,Mohammad Yousuf (Asia/PAK),1998-2010,283,283,58,58,0,0,58,2 (2ct 0st),0.204,
49,MA Ouma (KENYA),2004-2014,77,77,58,48,10,43,5,5 (3ct 2st),0.753,
0,AT Carey (AUS),2018-2021,45,45,57,51,6,51,0,5 (4ct 1st),1.266,
1,JO Holder (WI),2013-2022,118,118,57,57,0,0,57,2 (2ct 0st),0.483,
2,KO Otieno (KENYA),1996-2009,86,86,57,43,14,40,3,4 (3ct 1st),0.662,
3,Mohammad Nabi (AFG),2009-2021,124,124,56,56,0,0,56,3 (3ct 0st),0.451,
4,MA Taylor (AUS),1989-1997,113,113,56,56,0,0,56,4 (4ct 0st),0.495,
5,RA Harper (WI),1983-1996,104,104,55,55,0,0,55,3 (3ct 0st),0.528,
6,TD Paine (AUS),2009-2018,33,33,55,51,4,51,0,5 (5ct 0st),1.666,
7,IR Bell (ENG),2004-2015,155,155,54,54,0,0,54,3 (3ct 0st),0.348,
8,DM Jones (AUS),1984-1994,162,162,54,54,0,0,54,2 (2ct 0st),0.333,
9,PV Simmons (WI),1987-1999,141,141,54,54,0,0,54,4 (4ct 0st),0.382,
10,AJ Strauss (ENG),2003-2011,123,123,54,54,0,0,54,3 (3ct 0st),0.439,
11,DA Warner (AUS),2009-2020,123,123,54,54,0,0,54,2 (2ct 0st),0.439,
12,M Kaif (INDIA),2002-2006,118,118,53,53,0,0,53,4 (4ct 0st),0.449,
13,B Lee (AUS),2000-2012,209,209,53,53,0,0,53,3 (3ct 0st),0.253,
14,AD Mathews (SL),2008-2021,207,207,53,53,0,0,53,3 (3ct 0st),0.256,
15,JR Murray (WI),1992-1999,54,54,53,46,7,44,2,3 (3ct 0st),0.981,
16,JM Anderson (ENG),2002-2015,187,187,52,52,0,0,52,3 (3ct 0st),0.278,
17,Shakib Al Hasan (BAN),2006-2021,211,211,52,52,0,0,52,3 (3ct 0st),0.246,
18,PR Stirling (IRE),2008-2022,128,128,52,52,0,0,52,3 (3ct 0st),0.406,
19,JDP Oram (NZ),2001-2012,153,153,51,51,0,0,51,2 (2ct 0st),0.333,
20,SC Williams (ZIM),2005-2022,139,139,51,51,0,0,51,3 (3ct 0st),0.366,
21,AB Agarkar (INDIA),1998-2007,182,182,50,50,0,0,50,2 (2ct 0st),0.274,
22,CS Baugh (WI),2003-2012,45,45,50,38,12,38,0,4 (2ct 2st),1.111,
23,MDKJ Perera (SL),2013-2021,101,101,50,47,3,30,17,4 (4ct 0st),0.495,
24,P Utseya (ZIM),2004-2015,163,163,50,50,0,0,50,2 (2ct 0st),0.306,
25,JG Wright (NZ),1978-1992,144,144,50,50,0,0,50,2 (2ct 0st),0.347,
26,Aamer Sohail (PAK),1990-2000,153,153,49,49,0,0,49,2 (2ct 0st),0.32,
27,RW Chakabva (ZIM),2008-2022,49,49,49,44,5,32,12,5 (5ct 0st),1.0,
28,N Dickwella (SL),2014-2021,51,51,49,40,9,40,0,4 (2ct 2st),0.96,
29,AP Gurusinha (SL),1985-1996,142,142,49,49,0,2,47,2 (2ct 0st),0.345,
30,MN Samuels (WI),2000-2018,201,201,49,49,0,0,49,2 (2ct 0st),0.243,
31,WU Tharanga (Asia/SL),2005-2019,220,220,49,49,0,0,49,3 (3ct 0st),0.222,
32,RP Arnold (SL),1997-2007,175,175,48,48,0,0,48,2 (2ct 0st),0.274,
33,CR Ervine (ZIM),2010-2022,100,100,48,48,0,0,48,4 (4ct 0st),0.48,
34,AM Rahane (INDIA),2011-2018,86,86,48,48,0,0,48,2 (2ct 0st),0.558,
35,GJ Bailey (AUS),2012-2016,84,84,47,47,0,0,47,3 (3ct 0st),0.559,
36,BA Stokes (ENG),2011-2021,96,96,47,47,0,0,47,3 (3ct 0st),0.489,
37,ME Trescothick (ENG),2000-2006,116,116,47,47,0,4,43,3 (3ct 0st),0.405,
38,KC Wessels (AUS/SA),1983-1994,102,102,47,47,0,0,47,4 (4ct 0st),0.46,
39,RC Russell (ENG),1987-1998,38,38,46,40,6,40,0,3 (3ct 0st),1.21,
40,CEL Ambrose (WI),1988-2000,174,174,45,45,0,0,45,3 (3ct 0st),0.258,
41,DC Boon (AUS),1984-1995,178,178,45,45,0,0,45,2 (2ct 0st),0.252,
42,CG Greenidge (WI),1975-1991,126,126,45,45,0,0,45,2 (2ct 0st),0.357,
43,BKG Mendis (SL),2016-2022,79,79,45,42,3,4,38,3 (3ct 0st),0.569,
44,WB Phillips (AUS),1984-1986,44,44,45,38,7,38,0,4 (3ct 1st),1.022,
45,Sikandar Raza (ZIM),2013-2022,108,108,45,45,0,0,45,3 (3ct 0st),0.416,
46,J Smits (NED),2003-2009,36,36,45,38,7,38,0,4 (4ct 0st),1.25,
47,D Williams (WI),1988-1997,35,35,45,35,10,35,0,4 (4ct 0st),1.285,
48,CR Woakes (ENG),2011-2021,98,98,45,45,0,0,45,4 (4ct 0st),0.459,
49,A Flintoff (ENG/ICC),1999-2009,135,135,44,44,0,0,44,3 (3ct 0st),0.325,
0,GA Gooch (ENG),1976-1995,121,121,44,44,0,0,44,2 (2ct 0st),0.363,
1,DI Gower (ENG),1978-1991,113,113,44,44,0,0,44,3 (3ct 0st),0.389,
2,NV Knight (ENG),1996-2003,99,99,44,44,0,0,44,2 (2ct 0st),0.444,
3,KMDN Kulasekara (SL),2003-2017,173,173,44,44,0,0,44,3 (3ct 0st),0.254,
4,DO Obuya (KENYA),2001-2012,71,71,44,39,5,23,16,4 (1ct 3st),0.619,
5,RR Sarwan (WI),2000-2013,167,167,44,44,0,0,44,2 (2ct 0st),0.263,
6,HH Streak (Afr/ZIM),1993-2005,182,182,44,44,0,0,44,2 (2ct 0st),0.241,
7,Z Khan (Asia/INDIA),2000-2012,190,190,43,43,0,0,43,3 (3ct 0st),0.226,
8,CO Obuya (KENYA),2001-2014,103,103,43,43,0,0,43,3 (3ct 0st),0.417,
9,JM Bairstow (ENG),2011-2021,81,81,42,40,2,19,21,4 (4ct 0st),0.518,
10,BM McMillan (SA),1991-1998,76,76,42,42,0,0,42,3 (3ct 0st),0.552,
11,CD McMillan (NZ),1997-2007,185,185,42,42,0,0,42,2 (2ct 0st),0.227,
12,RL Powell (WI),1999-2005,101,101,42,42,0,0,42,3 (3ct 0st),0.415,
13,CMW Read (ENG),2000-2006,33,33,42,40,2,40,0,5 (5ct 0st),1.272,
14,Saeed Anwar (PAK),1989-2003,241,241,42,42,0,0,42,3 (3ct 0st),0.174,
15,V Sibanda (Afr/ZIM),2003-2016,124,124,42,42,0,0,42,2 (2ct 0st),0.338,
16,K Srikkanth (INDIA),1981-1992,142,142,42,42,0,0,42,2 (2ct 0st),0.295,
17,GP Thorpe (ENG),1993-2002,80,80,42,42,0,0,42,3 (3ct 0st),0.525,
18,KD Mills (NZ),2001-2015,160,160,41,41,0,0,41,3 (3ct 0st),0.256,
19,KR Rutherford (NZ),1985-1995,118,118,41,41,0,0,41,4 (4ct 0st),0.347,
20,L Vincent (NZ),2001-2007,98,98,41,41,0,2,39,2 (2ct 0st),0.418,
21,N Hussain (ENG),1989-2003,87,87,40,40,0,0,40,2 (2ct 0st),0.459,
22,Saqlain Mushtaq (PAK),1995-2003,166,166,40,40,0,0,40,2 (2ct 0st),0.24,
23,RJ Shastri (INDIA),1981-1992,144,144,40,40,0,0,40,2 (2ct 0st),0.277,
24,Babar Azam (PAK),2015-2021,80,80,39,39,0,0,39,2 (2ct 0st),0.487,
25,SV Carlisle (ZIM),1995-2005,109,109,39,39,0,0,39,3 (3ct 0st),0.357,
26,GH Dockrell (IRE),2010-2022,93,93,39,39,0,0,39,2 (2ct 0st),0.419,
27,VVS Laxman (INDIA),1998-2006,84,84,39,39,0,0,39,4 (4ct 0st),0.464,
28,CH Lloyd (WI),1973-1985,86,86,39,39,0,0,39,3 (3ct 0st),0.453,
29,PA Patel (INDIA),2003-2012,35,35,39,30,9,30,0,4 (3ct 1st),1.114,
30,TE Blain (NZ),1986-1994,38,38,38,37,1,36,1,4 (4ct 0st),1.0,
31,JV Coney (NZ),1979-1987,84,84,38,38,0,0,38,3 (3ct 0st),0.452,
32,Mohammad Rizwan (PAK),2015-2021,41,41,38,37,1,25,12,4 (4ct 0st),0.926,
33,DL Murray (WI),1973-1980,26,26,38,37,1,37,0,4 (4ct 0st),1.461,
34,Najibullah Zadran (AFG),2012-2022,72,72,38,38,0,0,38,3 (3ct 0st),0.527,
35,KP Pietersen (ENG/ICC),2004-2013,129,129,38,38,0,0,38,2 (2ct 0st),0.294,
36,TG Southee (NZ),2008-2020,133,133,38,38,0,0,38,3 (3ct 0st),0.285,
37,Azhar Mahmood (PAK),1996-2007,140,140,37,37,0,0,37,2 (2ct 0st),0.264,
38,AG Cremer (ZIM),2009-2018,94,94,37,37,0,0,37,2 (2ct 0st),0.393,
39,Liton Das (BAN),2015-2021,47,47,37,34,3,10,24,4 (4ct 0st),0.787,
40,GD McGrath (AUS/ICC),1993-2007,245,245,37,37,0,0,37,3 (3ct 0st),0.151,
41,S Matsikenyeri (ZIM),2002-2015,112,112,37,37,0,0,37,3 (3ct 0st),0.33,
42,Sabbir Rahman (BAN),2014-2019,63,63,37,37,0,0,37,3 (3ct 0st),0.587,
43,HDRL Thirimanne (SL),2010-2019,120,120,37,37,0,0,37,2 (2ct 0st),0.308,
44,LJ Tucker (IRE),2019-2022,24,24,37,36,1,35,1,4 (4ct 0st),1.541,
45,MM Ali (ENG),2014-2021,108,108,36,36,0,0,36,3 (3ct 0st),0.333,
46,J Botha (Afr/SA),2005-2012,77,77,36,36,0,0,36,3 (3ct 0st),0.467,
47,IT Botham (ENG),1976-1992,114,114,36,36,0,0,36,2 (2ct 0st),0.315,
48,G Gambhir (INDIA),2003-2013,139,139,36,36,0,0,36,3 (3ct 0st),0.258,
49,Imran Khan (PAK),1974-1992,171,171,36,36,0,0,36,3 (3ct 0st),0.21,
0,SMH Kirmani (INDIA),1976-1986,48,48,36,27,9,27,0,5 (5ct 0st),0.75,
1,NL McCullum (NZ),2009-2015,78,78,36,36,0,0,36,4 (4ct 0st),0.461,
2,DB Vengsarkar (INDIA),1976-1991,124,124,36,36,0,0,36,3 (3ct 0st),0.29,
3,CL White (AUS),2005-2018,87,87,36,36,0,0,36,3 (3ct 0st),0.413,
4,Abdul Razzaq (Asia/PAK),1996-2011,259,259,35,35,0,0,35,2 (2ct 0st),0.135,
5,RS Bopara (ENG),2007-2015,116,116,35,35,0,0,35,2 (2ct 0st),0.301,
6,AN Cook (ENG),2006-2014,90,90,35,35,0,0,35,2 (2ct 0st),0.388,
7,MJ Greatbatch (NZ),1988-1996,84,84,35,35,0,1,34,2 (2ct 0st),0.416,
8,GB Hogg (AUS),1996-2008,117,117,35,35,0,0,35,2 (2ct 0st),0.299,
9,MG Johnson (AUS),2005-2015,142,142,35,35,0,0,35,2 (2ct 0st),0.246,
10,DSBP Kuruppu (SL),1983-1990,52,52,35,27,8,23,4,4 (3ct 1st),0.673,
11,RG Twose (NZ),1995-2001,81,81,35,35,0,0,35,2 (2ct 0st),0.432,
12,Waqar Younis (PAK),1989-2003,258,258,35,35,0,0,35,2 (2ct 0st),0.135,
13,TA Boult (NZ),2012-2021,90,90,34,34,0,0,34,2 (2ct 0st),0.377,
14,DM Bravo (WI),2009-2021,115,115,34,34,0,0,34,3 (3ct 0st),0.295,
15,HH Dippenaar (Afr/SA),1999-2007,103,103,34,34,0,2,32,3 (3ct 0st),0.33,
16,L Klusener (SA),1996-2004,166,166,34,34,0,0,34,2 (2ct 0st),0.204,
17,Mohammad Ashraful (Asia/BAN),2001-2013,173,173,34,34,0,0,34,2 (2ct 0st),0.196,
18,BKV Prasad (INDIA),1994-2001,153,153,34,34,0,0,34,3 (3ct 0st),0.222,
19,AU Rashid (ENG),2009-2021,105,105,34,34,0,0,34,3 (3ct 0st),0.323,
20,JJ Roy (ENG),2015-2021,92,92,34,34,0,0,34,2 (2ct 0st),0.369,
21,PL Taylor (AUS),1987-1992,82,82,34,34,0,0,34,2 (2ct 0st),0.414,
22,GJ Whittall (ZIM),1993-2003,143,143,34,34,0,0,34,4 (4ct 0st),0.237,
23,CJ Chibhabha (ZIM),2005-2020,105,105,33,33,0,0,33,2 (2ct 0st),0.314,
24,HDPK Dharmasena (SL),1994-2004,134,134,33,33,0,0,33,2 (2ct 0st),0.246,
25,NH Fairbrother (ENG),1987-1999,74,74,33,33,0,0,33,3 (3ct 0st),0.445,
26,KM Jadhav (INDIA),2014-2020,71,71,33,33,0,0,33,3 (3ct 0st),0.464,
27,JM Kemp (Afr/SA),2001-2007,81,81,33,33,0,0,33,3 (3ct 0st),0.407,
28,Ramiz Raja (PAK),1985-1997,192,192,33,33,0,0,33,2 (2ct 0st),0.171,
29,RR Singh (INDIA),1989-2001,127,127,33,33,0,0,33,2 (2ct 0st),0.259,
30,Soumya Sarkar (BAN),2014-2021,58,58,33,33,0,0,33,4 (4ct 0st),0.568,
31,MA Starc (AUS),2010-2021,94,94,33,33,0,0,33,3 (3ct 0st),0.351,
32,Abdur Razzak (BAN),2004-2014,152,152,32,32,0,0,32,2 (2ct 0st),0.21,
33,N Boje (Afr/SA),1995-2005,112,112,32,32,0,0,32,2 (2ct 0st),0.285,
34,Ghulam Shabber (UAE),2017-2019,23,23,32,30,2,30,0,4 (4ct 0st),1.391,
35,CS MacLeod (SCOT),2009-2021,68,68,32,32,0,0,32,4 (4ct 0st),0.47,
36,Nasir Hossain (BAN),2011-2018,63,63,32,32,0,0,32,2 (2ct 0st),0.507,
37,J Srinath (INDIA),1991-2003,222,222,32,32,0,0,32,2 (2ct 0st),0.144,
38,DL Houghton (ZIM),1983-1997,62,62,31,29,2,10,19,4 (4ct 0st),0.5,
39,RS Kalpage (SL),1992-1999,79,79,31,31,0,0,31,3 (3ct 0st),0.392,
40,H Klaasen (SA),2018-2021,24,24,31,26,5,18,8,4 (3ct 1st),1.291,
41,AJ Lamb (ENG),1982-1992,120,120,31,31,0,0,31,2 (2ct 0st),0.258,
42,SL Malinga (SL),2004-2019,212,212,31,31,0,0,31,2 (2ct 0st),0.146,
43,GR Marsh (AUS),1986-1992,115,115,31,31,0,0,31,2 (2ct 0st),0.269,
44,M Morkel (Afr/SA),2007-2018,113,113,31,31,0,0,31,3 (3ct 0st),0.274,
45,CJO Smith (SCOT),2006-2009,24,24,31,20,11,20,0,5 (5ct 0st),1.291,
46,DR Smith (WI),2004-2015,98,98,31,31,0,0,31,2 (2ct 0st),0.316,
47,RW Taylor (ENG),1973-1984,25,25,31,25,6,25,0,4 (4ct 0st),1.24,
48,R Ashwin (INDIA),2010-2022,109,109,30,30,0,0,30,3 (3ct 0st),0.275,
49,RD Berrington (SCOT),2008-2021,79,79,30,30,0,0,30,2 (2ct 0st),0.379,
0,J Garner (WI),1977-1987,97,97,30,30,0,0,30,3 (3ct 0st),0.309,
1,MA Holding (WI),1976-1987,101,101,30,30,0,0,30,3 (3ct 0st),0.297,
2,WK Lees (NZ),1979-1983,31,31,30,28,2,28,0,4 (4ct 0st),0.967,
3,MR Marsh (AUS),2011-2021,60,60,30,30,0,0,30,4 (4ct 0st),0.5,
4,Mushtaq Ahmed (PAK),1989-2003,143,143,30,30,0,0,30,2 (2ct 0st),0.209,
5,M Ntini (ICC/SA),1998-2009,167,167,30,30,0,0,30,2 (2ct 0st),0.179,
6,MJ Santner (NZ),2015-2021,73,73,30,30,0,0,30,2 (2ct 0st),0.41,
7,PA Strang (ZIM),1994-2001,94,94,30,30,0,0,30,2 (2ct 0st),0.319,
8,Aftab Ahmed (BAN),2004-2010,85,85,29,29,0,0,29,3 (3ct 0st),0.341,
9,TM Alderman (AUS),1981-1991,64,64,29,29,0,0,29,3 (3ct 0st),0.453,
10,PR Downton (ENG),1977-1988,28,28,29,26,3,26,0,4 (4ct 0st),1.035,
11,LK Germon (NZ),1995-1997,36,36,29,20,9,20,0,4 (4ct 0st),0.805,
12,AJ Hall (SA),1999-2007,84,84,29,29,0,0,29,2 (2ct 0st),0.345,
13,WW Hinds (WI),1999-2010,113,113,29,29,0,0,29,2 (2ct 0st),0.256,
14,DJ Hussey (AUS),2008-2013,65,65,29,29,0,0,29,2 (2ct 0st),0.446,
15,CK Kapugedera (SL),2006-2017,95,95,29,29,0,0,29,2 (2ct 0st),0.305,
16,SS Karim (INDIA),1997-2000,32,32,29,26,3,26,0,4 (3ct 1st),0.906,
17,B Kumar (INDIA),2012-2022,119,119,29,29,0,0,29,2 (2ct 0st),0.243,
18,CS Pandit (INDIA),1986-1992,35,35,29,15,14,15,0,4 (2ct 2st),0.828,
19,GP Swann (ENG),2000-2013,77,77,29,29,0,0,29,3 (3ct 0st),0.376,
20,DC Thomas (WI),2009-2013,21,21,29,23,6,23,0,3 (3ct 0st),1.38,
21,Wahab Riaz (PAK),2008-2020,89,89,29,29,0,0,29,2 (2ct 0st),0.325,
22,Ahmed Shehzad (PAK),2009-2017,80,80,28,28,0,0,28,2 (2ct 0st),0.35,
23,RG de Alwis (SL),1983-1988,30,30,28,25,3,25,0,5 (5ct 0st),0.933,
24,AA Donald (SA),1991-2003,160,160,28,28,0,0,28,2 (2ct 0st),0.175,
25,GC Dyer (AUS),1986-1988,22,22,28,24,4,24,0,4 (4ct 0st),1.272,
26,Mohammad Rafique (Asia/BAN),1995-2007,123,123,28,28,0,0,28,2 (2ct 0st),0.227,
27,Mohammed Shami (INDIA),2013-2020,75,75,28,28,0,0,28,2 (2ct 0st),0.373,
28,R Mutumbami (ZIM),2014-2020,35,35,28,23,5,21,2,4 (4ct 0st),0.8,
29,TM Odoyo (Afr/KENYA),1996-2014,130,130,28,28,0,0,28,2 (2ct 0st),0.215,
30,LMP Simmons (WI),2006-2015,67,67,28,28,0,2,26,2 (2ct 0st),0.417,
31,DW Steyn (Afr/SA),2005-2019,123,123,28,28,0,0,28,2 (2ct 0st),0.227,
32,Alok Kapali (BAN),2002-2011,67,67,27,27,0,0,27,2 (2ct 0st),0.402,
33,KLT Arthurton (WI),1988-1999,102,102,27,27,0,0,27,2 (2ct 0st),0.264,
34,F Behardien (SA),2013-2018,58,58,27,27,0,0,27,2 (2ct 0st),0.465,
35,SCJ Broad (ENG),2006-2016,116,116,27,27,0,0,27,2 (2ct 0st),0.232,
36,JJ Crowe (NZ),1983-1990,73,73,27,27,0,0,27,2 (2ct 0st),0.369,
37,DM de Silva (SL),2016-2021,53,53,27,27,0,0,27,3 (3ct 0st),0.509,
38,CRD Fernando (Asia/SL),2001-2012,143,143,27,27,0,0,27,3 (3ct 0st),0.188,
39,EC Joyce (ENG/IRE),2006-2018,75,75,27,27,0,0,27,2 (2ct 0st),0.36,
40,CJ McDermott (AUS),1985-1996,136,136,27,27,0,0,27,1 (1ct 0st),0.198,
41,RJ Peterson (SA),2002-2014,77,77,27,27,0,0,27,2 (2ct 0st),0.35,
42,M Prabhakar (INDIA),1984-1996,127,127,27,27,0,0,27,3 (3ct 0st),0.212,
43,CA Walsh (WI),1985-2000,200,200,27,27,0,0,27,1 (1ct 0st),0.135,
44,BA Young (NZ),1990-1999,69,69,27,27,0,6,21,3 (3ct 0st),0.391,
45,A Balbirnie (IRE),2010-2022,79,79,26,26,0,0,26,4 (4ct 0st),0.329,
46,PW Borren (NED),2006-2014,55,55,26,26,0,0,26,3 (3ct 0st),0.472,
47,NW Bracken (AUS),2001-2009,113,113,26,26,0,0,26,2 (2ct 0st),0.23,
48,PAJ DeFreitas (ENG),1987-1997,102,102,26,26,0,0,26,2 (2ct 0st),0.254,
49,JEC Franklin (NZ),2001-2013,104,104,26,26,0,0,26,2 (2ct 0st),0.25,
0,Habibul Bashar (BAN),1995-2007,110,110,26,26,0,0,26,2 (2ct 0st),0.236,
1,AD Hales (ENG),2014-2019,66,66,26,26,0,0,26,2 (2ct 0st),0.393,
2,GJ Hopkins (NZ),2004-2010,21,21,26,25,1,25,0,5 (5ct 0st),1.238,
3,KJ Hughes (AUS),1977-1985,91,91,26,26,0,0,26,2 (2ct 0st),0.285,
4,Imran Nazir (PAK),1999-2009,78,78,26,26,0,0,26,3 (3ct 0st),0.333,
5,DS Lehmann (AUS),1996-2005,115,115,26,26,0,0,26,3 (3ct 0st),0.226,
6,MF Maharoof (SL),2004-2016,104,104,26,26,0,0,26,2 (2ct 0st),0.25,
7,LE Plunkett (ENG),2005-2019,85,85,26,26,0,0,26,2 (2ct 0st),0.305,
8,K Rabada (SA),2015-2021,79,79,26,26,0,0,26,2 (2ct 0st),0.329,
9,GP Wickramasinghe (SL),1990-2002,126,126,26,26,0,0,26,2 (2ct 0st),0.206,
10,B Zuiderent (NED),1996-2011,55,55,26,26,0,0,26,2 (2ct 0st),0.472,
11,W Barresi (NED),2010-2019,31,31,25,17,8,13,4,3 (3ct 0st),0.806,
12,D Gough (ENG/ICC),1994-2006,152,152,25,25,0,0,25,1 (1ct 0st),0.164,
13,JR Hopes (AUS),2005-2010,78,78,25,25,0,0,25,2 (2ct 0st),0.32,
14,Imran Tahir (SA),2011-2019,104,104,25,25,0,0,25,2 (2ct 0st),0.24,
15,DT Johnston (IRE),2006-2013,64,64,25,25,0,0,25,2 (2ct 0st),0.39,
16,AR McBrine (IRE),2014-2022,61,61,25,25,0,0,25,3 (3ct 0st),0.409,
17,AG Prince (Afr/SA),2002-2007,48,48,25,25,0,0,25,4 (4ct 0st),0.52,
18,KL Rahul (INDIA),2016-2022,41,41,25,23,2,13,10,3 (3ct 0st),0.609,
19,DW Randall (ENG),1976-1985,48,48,25,25,0,0,25,2 (2ct 0st),0.52,
20,Rashid Khan (AFG),2015-2022,74,74,25,25,0,0,25,3 (3ct 0st),0.337,
21,PR Reiffel (AUS),1992-1999,92,92,25,25,0,0,25,2 (2ct 0st),0.271,
22,Saeed Ajmal (PAK),2008-2015,112,112,25,25,0,0,25,1 (1ct 0st),0.223,
23,RA Smith (ENG),1988-1996,68,68,25,25,0,0,25,2 (2ct 0st),0.367,
24,MP Vaughan (ENG),2001-2007,81,81,25,25,0,0,25,3 (3ct 0st),0.308,
25,CB Wishart (ZIM),1996-2005,88,88,25,25,0,0,25,2 (2ct 0st),0.284,
26,Aaqib Javed (PAK),1988-1998,158,158,24,24,0,0,24,1 (1ct 0st),0.151,
27,Asghar Afghan (AFG),2009-2021,111,111,24,24,0,0,24,2 (2ct 0st),0.216,
28,V Dahiya (INDIA),2000-2001,19,19,24,19,5,19,0,3 (3ct 0st),1.263,
29,SS Dighe (INDIA),2000-2001,23,23,24,19,5,19,0,4 (4ct 0st),1.043,
30,NM Hauritz (AUS),2002-2011,56,56,24,24,0,0,24,2 (2ct 0st),0.428,
31,DJ Nash (NZ),1992-2002,74,74,24,24,0,0,24,3 (3ct 0st),0.324,
32,JDS Neesham (NZ),2013-2021,64,64,24,24,0,0,24,2 (2ct 0st),0.375,
33,HH Pandya (INDIA),2016-2021,62,62,24,24,0,0,24,2 (2ct 0st),0.387,
34,Wasim Raja (PAK),1973-1985,52,52,24,24,0,0,24,2 (2ct 0st),0.461,
35,M Amarnath (INDIA),1975-1989,83,83,23,23,0,0,23,2 (2ct 0st),0.277,
36,GS Chappell (AUS),1971-1983,71,71,23,23,0,0,23,2 (2ct 0st),0.323,
37,DD Ebrahim (ZIM),2001-2005,79,79,23,23,0,0,23,2 (2ct 0st),0.291,
38,Fakhar Zaman (PAK),2017-2021,51,51,23,23,0,0,23,2 (2ct 0st),0.45,
39,Sir RJ Hadlee (NZ),1973-1990,108,108,23,23,0,0,23,2 (2ct 0st),0.212,
40,AH Jones (NZ),1987-1995,86,86,23,23,0,0,23,2 (2ct 0st),0.267,
41,Junaid Siddique (BAN),2007-2011,54,54,23,23,0,1,22,3 (3ct 0st),0.425,
42,S Lee (AUS),1995-2001,44,44,23,23,0,0,23,2 (2ct 0st),0.522,
43,GRJ Matthews (AUS),1984-1993,57,57,23,23,0,0,23,3 (3ct 0st),0.403,
44,PJ Moor (ZIM),2014-2019,48,48,23,22,1,16,6,4 (4ct 0st),0.479,
45,PA Nixon (ENG),2007-2007,19,19,23,20,3,20,0,2 (2ct 0st),1.21,
46,DN Patel (NZ),1987-1997,75,75,23,23,0,0,23,2 (2ct 0st),0.306,
47,PL Symcox (SA),1993-1999,78,78,23,23,0,0,23,2 (2ct 0st),0.294,
48,S Viswanath (INDIA),1985-1988,21,21,23,16,7,16,0,5 (3ct 2st),1.095,
49,TJ Zoehrer (AUS),1986-1994,22,22,23,21,2,21,0,4 (4ct 0st),1.045,
0,Zulqarnain (PAK),1985-1989,14,14,23,18,5,18,0,4 (4ct 0st),1.642,
1,Afsar Zazai (AFG),2014-2017,16,16,22,20,2,20,0,3 (3ct 0st),1.375,
2,SL Campbell (WI),1994-2001,87,87,22,22,0,0,22,3 (3ct 0st),0.252,
3,J Charles (WI),2012-2016,48,48,22,21,1,10,11,2 (2ct 0st),0.458,
4,MW Gatting (ENG),1977-1993,92,92,22,22,0,0,22,2 (2ct 0st),0.239,
5,SM Gavaskar (INDIA),1974-1987,105,105,22,22,0,0,22,4 (4ct 0st),0.209,
6,AF Giles (ENG),1997-2005,59,59,22,22,0,0,22,3 (3ct 0st),0.372,
7,GR Larsen (NZ),1990-1999,117,117,22,22,0,0,22,1 (1ct 0st),0.188,
8,SV Manjrekar (INDIA),1988-1996,72,72,22,22,0,0,22,2 (2ct 0st),0.305,
9,SE Marsh (AUS),2008-2019,72,72,22,22,0,0,22,2 (2ct 0st),0.305,
10,PL Mommsen (SCOT),2010-2017,41,41,22,22,0,0,22,2 (2ct 0st),0.536,
11,C Munro (NZ),2013-2019,55,55,22,22,0,0,22,2 (2ct 0st),0.4,
12,SP O'Donnell (AUS),1985-1991,87,87,22,22,0,0,22,2 (2ct 0st),0.252,
13,SW Poynter (IRE),2014-2019,20,20,22,22,0,19,3,4 (4ct 0st),1.1,
14,RR Rossouw (SA),2014-2016,35,35,22,22,0,0,22,4 (4ct 0st),0.628,
15,MN Waller (ZIM),2009-2018,79,79,22,22,0,0,22,1 (1ct 0st),0.278,
16,DJ Willey (ENG),2015-2021,48,48,22,22,0,0,22,2 (2ct 0st),0.458,
17,RGD Willis (ENG),1973-1984,64,64,22,22,0,0,22,2 (2ct 0st),0.343,
18,Abdul Qadir (PAK),1983-1993,102,102,21,21,0,0,21,2 (2ct 0st),0.205,
19,DL Bairstow (ENG),1979-1984,21,21,21,17,4,17,0,3 (3ct 0st),1.0,
20,JP Faulkner (AUS),2013-2017,64,64,21,21,0,0,21,1 (1ct 0st),0.328,
21,Imrul Kayes (BAN),2008-2018,77,77,21,21,0,0,21,2 (2ct 0st),0.272,
22,Manzoor Elahi (PAK),1984-1995,53,53,21,21,0,0,21,2 (2ct 0st),0.396,
23,TM Moody (AUS),1987-1999,75,75,21,21,0,0,21,2 (2ct 0st),0.28,
24,Mudassar Nazar (PAK),1977-1989,117,117,21,21,0,0,21,2 (2ct 0st),0.179,
25,IK Pathan (INDIA),2004-2012,114,114,21,21,0,0,21,1 (1ct 0st),0.184,
26,MSK Prasad (INDIA),1998-1999,17,17,21,14,7,14,0,5 (4ct 1st),1.235,
27,KAJ Roach (WI),2008-2019,89,89,21,21,0,0,21,2 (2ct 0st),0.235,
28,Samiullah Shinwari (AFG),2009-2019,84,84,21,21,0,0,21,2 (2ct 0st),0.25,
29,RV Uthappa (INDIA),2006-2015,42,42,21,19,2,4,15,3 (3ct 0st),0.5,
30,AR White (IRE),2006-2014,60,60,21,21,0,0,21,2 (2ct 0st),0.35,
31,UT Yadav (INDIA),2010-2018,72,72,21,21,0,0,21,3 (3ct 0st),0.291,
32,Ashraf Ali (PAK),1980-1985,15,15,20,17,3,17,0,3 (3ct 0st),1.333,
33,GB Brent (ZIM),1996-2008,68,68,20,20,0,0,20,2 (2ct 0st),0.294,
34,TT Bresnan (ENG),2006-2014,81,81,20,20,0,0,20,2 (2ct 0st),0.246,
35,CK Coventry (ZIM),2003-2015,38,38,20,19,1,0,19,1 (1ct 0st),0.526,
36,DN Crookes (SA),1994-2000,32,32,20,20,0,0,20,2 (2ct 0st),0.625,
37,JS Foster (ENG),2001-2002,11,11,20,13,7,13,0,3 (2ct 1st),1.818,
38,JK Kamande (KENYA),1999-2011,82,82,20,20,0,0,20,2 (2ct 0st),0.243,
39,RAS Lakmal (SL),2009-2021,82,82,20,20,0,0,20,1 (1ct 0st),0.243,
40,ND McKenzie (SA),2000-2009,63,63,20,20,0,0,20,3 (3ct 0st),0.317,
41,Mehidy Hasan Miraz (BAN),2017-2021,49,49,20,20,0,0,20,3 (3ct 0st),0.408,
42,DA Minors (BMUDA),2006-2007,20,20,20,16,4,12,4,3 (3ct 0st),1.0,
43,D Mongia (INDIA),2001-2007,53,53,20,20,0,0,20,3 (3ct 0st),0.377,
44,RS Morton (WI),2002-2010,52,52,20,20,0,0,20,3 (3ct 0st),0.384,
45,A Nel (SA),2001-2008,75,75,20,20,0,0,20,2 (2ct 0st),0.266,
46,HM Nicholls (NZ),2015-2021,50,50,20,20,0,0,20,2 (2ct 0st),0.4,
47,Rubel Hossain (BAN),2009-2021,101,101,20,20,0,0,20,2 (2ct 0st),0.198,
48,Salman Butt (PAK),2004-2010,77,77,20,20,0,0,20,2 (2ct 0st),0.259,
49,OA Shah (ENG),2001-2009,68,68,20,20,0,0,20,2 (2ct 0st),0.294,
0,Shoaib Akhtar (Asia/ICC/PAK),1998-2011,160,160,20,20,0,0,20,2 (2ct 0st),0.125,
1,NS Sidhu (INDIA),1987-1998,131,131,20,20,0,0,20,2 (2ct 0st),0.152,
2,LPC Silva (SL),1999-2011,71,71,20,20,0,0,20,3 (3ct 0st),0.281,
3,JE Taylor (WI),2003-2017,86,86,20,20,0,0,20,2 (2ct 0st),0.232,
4,DR Tuffey (NZ),2000-2010,89,89,20,20,0,0,20,3 (3ct 0st),0.224,
5,AR Whittall (ZIM),1996-2000,61,61,20,20,0,0,20,3 (3ct 0st),0.327,
6,Akram Raza (PAK),1989-1995,49,49,19,19,0,0,19,2 (2ct 0st),0.387,
7,AJ Bichel (AUS),1997-2004,66,66,19,19,0,0,19,2 (2ct 0st),0.287,
8,BL Cairns (NZ),1974-1985,76,76,19,19,0,0,19,2 (2ct 0st),0.25,
9,EJ Chatfield (NZ),1979-1989,110,110,19,19,0,0,19,2 (2ct 0st),0.172,
10,SS Cottrell (WI),2015-2021,35,35,19,19,0,0,19,3 (3ct 0st),0.542,
11,XJ Doherty (AUS),2010-2015,55,55,19,19,0,0,19,2 (2ct 0st),0.345,
12,JE Emburey (ENG),1980-1993,61,61,19,19,0,0,19,2 (2ct 0st),0.311,
13,MW Goodwin (ZIM),1998-2000,69,69,19,19,0,0,19,2 (2ct 0st),0.275,
14,Gulbadin Naib (AFG),2011-2022,68,68,19,19,0,0,19,3 (3ct 0st),0.279,
15,SO Hetmyer (WI),2017-2021,44,44,19,19,0,3,16,3 (3ct 0st),0.431,
16,JM How (NZ),2005-2011,37,37,19,19,0,0,19,4 (4ct 0st),0.513,
17,NC Johnson (ZIM),1998-2000,47,47,19,19,0,0,19,2 (2ct 0st),0.404,
18,CC Lewis (ENG),1990-1998,49,49,19,19,0,0,19,2 (2ct 0st),0.387,
19,E Lewis (WI),2016-2021,53,53,19,19,0,0,19,2 (2ct 0st),0.358,
20,AF Milne (NZ),2012-2017,36,36,19,19,0,0,19,3 (3ct 0st),0.527,
21,Mohammad Sami (PAK),2001-2015,85,85,19,19,0,0,19,2 (2ct 0st),0.223,
22,JF Mooney (IRE),2006-2015,61,61,19,19,0,0,19,2 (2ct 0st),0.311,
23,DK Morrison (NZ),1987-1996,96,96,19,19,0,0,19,2 (2ct 0st),0.197,
24,Naeem Islam (BAN),2008-2014,59,59,19,19,0,0,19,2 (2ct 0st),0.322,
25,Nawroz Mangal (AFG),2009-2016,49,49,19,19,0,0,19,2 (2ct 0st),0.387,
26,CJ Nevin (NZ),2000-2003,35,35,19,16,3,14,2,3 (3ct 0st),0.542,
27,Rahmat Shah (AFG),2013-2022,76,76,19,19,0,0,19,2 (2ct 0st),0.25,
28,SMSM Senanayake (SL),2012-2015,46,46,19,19,0,0,19,3 (3ct 0st),0.413,
29,I Sharma (INDIA),2007-2016,74,74,19,19,0,0,19,1 (1ct 0st),0.256,
30,SAR Silva (SL),1984-1985,19,19,19,16,3,16,0,3 (3ct 0st),1.0,
31,MC Snedden (NZ),1980-1990,91,91,19,19,0,0,19,1 (1ct 0st),0.208,
32,AO Suji (KENYA),1996-2008,57,57,19,19,0,0,19,2 (2ct 0st),0.333,
33,A Vala (PNG),2014-2021,35,35,19,19,0,0,19,3 (3ct 0st),0.542,
34,V Yadav (INDIA),1992-1994,19,19,19,12,7,12,0,3 (2ct 1st),1.0,
35,Asif Mujtaba (PAK),1986-1996,66,66,18,18,0,0,18,3 (3ct 0st),0.272,
36,SW Billings (ENG),2015-2021,24,24,18,18,0,4,14,2 (2ct 0st),0.75,
37,JG Bracewell (NZ),1983-1990,51,51,18,18,0,0,18,3 (3ct 0st),0.352,
38,AF Buurman (NED),2007-2011,16,16,18,15,3,15,0,3 (3ct 0st),1.125,
39,AR Cusack (IRE),2007-2015,55,55,18,18,0,0,18,2 (2ct 0st),0.327,
40,M Dillon (WI),1997-2005,101,101,18,18,0,0,18,2 (2ct 0st),0.178,
41,PG Fulton (NZ),2004-2009,47,47,18,18,0,0,18,2 (2ct 0st),0.382,
42,IJ Gould (ENG),1983-1983,18,18,18,15,3,15,0,3 (3ct 0st),1.0,
43,CJ Jordan (ENG),2013-2020,32,32,18,18,0,0,18,2 (2ct 0st),0.562,
44,SB Joshi (INDIA),1996-2001,67,67,18,18,0,0,18,2 (2ct 0st),0.268,
45,GF Lawson (AUS),1980-1989,75,75,18,18,0,0,18,2 (2ct 0st),0.24,
46,MA Leask (SCOT),2014-2021,36,36,18,18,0,0,18,3 (3ct 0st),0.5,
47,RS Madugalle (SL),1979-1988,60,60,18,18,0,0,18,2 (2ct 0st),0.3,
48,JP Maher (AUS),1998-2003,25,25,18,18,0,8,10,3 (3ct 0st),0.72,
49,HJH Marshall (NZ),2003-2007,63,63,18,18,0,0,18,3 (3ct 0st),0.285,
0,NO Miller (WI),2008-2018,46,46,18,18,0,0,18,3 (3ct 0st),0.391,
1,A Nehra (Asia/INDIA),2001-2011,114,114,18,18,0,0,18,2 (2ct 0st),0.157,
2,RR Patel (KENYA),2008-2014,38,38,18,18,0,0,18,2 (2ct 0st),0.473,
3,Raqibul Hasan (BAN),2008-2011,55,55,18,18,0,0,18,2 (2ct 0st),0.327,
4,WP Saha (INDIA),2010-2014,8,8,18,17,1,17,0,4 (4ct 0st),2.25,
5,SA Thomson (NZ),1990-1996,55,55,18,18,0,0,18,2 (2ct 0st),0.327,
6,MA Vermeulen (ZIM),2000-2009,42,42,18,18,0,0,18,3 (3ct 0st),0.428,
7,DP Viljoen (ZIM),1997-2001,53,53,18,18,0,0,18,2 (2ct 0st),0.339,
8,SC Williams (WI),1994-1999,56,56,18,18,0,0,18,3 (3ct 0st),0.321,
9,Ahmed Raza (UAE),2014-2021,33,33,17,17,0,0,17,3 (3ct 0st),0.515,
10,JJ Bumrah (INDIA),2016-2022,70,70,17,17,0,0,17,2 (2ct 0st),0.242,
11,JM Davison (CAN),2003-2011,32,32,17,17,0,0,17,2 (2ct 0st),0.531,
12,Haris Sohail (PAK),2013-2020,40,40,17,17,0,0,17,2 (2ct 0st),0.425,
13,IJ Harvey (AUS),1997-2004,72,72,17,17,0,0,17,2 (2ct 0st),0.236,
14,AC Hudson (SA),1991-1997,86,86,17,17,0,0,17,2 (2ct 0st),0.197,
15,EB McSweeney (NZ),1986-1987,15,15,17,14,3,14,0,3 (3ct 0st),1.133,
16,S Madan Lal (INDIA),1974-1987,63,63,17,17,0,0,17,2 (2ct 0st),0.269,
17,Maninder Singh (INDIA),1983-1993,56,56,17,17,0,0,17,2 (2ct 0st),0.303,
18,AK Markram (SA),2017-2022,35,35,17,17,0,0,17,3 (3ct 0st),0.485,
19,YK Pathan (INDIA),2008-2012,55,55,17,17,0,0,17,3 (3ct 0st),0.309,
20,RW Price (ZIM),2002-2012,101,101,17,17,0,0,17,2 (2ct 0st),0.168,
21,WB Rankin (ENG/IRE),2007-2020,72,72,17,17,0,0,17,2 (2ct 0st),0.236,
22,AT Rayudu (INDIA),2013-2019,53,53,17,17,0,0,17,2 (2ct 0st),0.32,
23,CJ Richards (ENG),1981-1988,22,22,17,16,1,16,0,3 (3ct 0st),0.772,
24,TT Samaraweera (SL),1998-2011,50,50,17,17,0,0,17,2 (2ct 0st),0.34,
25,MS Sinclair (NZ),2000-2007,53,53,17,17,0,2,15,2 (2ct 0st),0.32,
26,Umar Gul (PAK),2003-2016,128,128,17,17,0,0,17,2 (2ct 0st),0.132,
27,BJ Watling (NZ),2010-2016,25,25,17,17,0,11,6,3 (3ct 0st),0.68,
28,LJ Wright (ENG),2007-2014,47,47,17,17,0,0,17,2 (2ct 0st),0.361,
29,Aamer Malik (PAK),1988-1994,24,24,16,13,3,10,3,2 (2ct 0st),0.666,
30,CWJ Athey (ENG),1980-1988,31,31,16,16,0,0,16,3 (3ct 0st),0.516,
31,JJ Atkinson (HKG),2008-2017,9,9,16,10,6,10,0,4 (4ct 0st),1.777,
32,WKM Benjamin (WI),1986-1995,85,85,16,16,0,0,16,1 (1ct 0st),0.188,
33,YS Chahal (INDIA),2016-2022,59,59,16,16,0,0,16,2 (2ct 0st),0.271,
34,N Chopra (INDIA),1998-2000,37,37,16,16,0,0,16,2 (2ct 0st),0.432,
35,KJ Coetzer (SCOT),2009-2021,60,60,16,16,0,0,16,2 (2ct 0st),0.266,
36,PJ Cummins (AUS),2011-2020,66,66,16,16,0,0,16,2 (2ct 0st),0.242,
37,Dawlat Zadran (AFG),2011-2019,80,80,16,16,0,0,16,2 (2ct 0st),0.2,
38,GD Elliott (NZ),2008-2016,76,76,16,16,0,0,16,2 (2ct 0st),0.21,
39,BN French (ENG),1985-1988,13,13,16,13,3,13,0,3 (3ct 0st),1.23,
40,JR Hazlewood (AUS),2010-2021,51,51,16,16,0,0,16,2 (2ct 0st),0.313,
41,BJ Hodge (AUS),2005-2007,24,24,16,16,0,0,16,2 (2ct 0st),0.666,
42,Khaled Mahmud (BAN),1998-2006,76,76,16,16,0,0,16,2 (2ct 0st),0.21,
43,APE Knott (ENG),1971-1977,19,19,16,15,1,15,0,4 (4ct 0st),0.842,
44,T Mishra (KENYA),2006-2013,42,42,16,16,0,0,16,2 (2ct 0st),0.38,
45,Mosaddek Hossain (BAN),2016-2021,38,38,16,16,0,0,16,2 (2ct 0st),0.421,
46,DA Murray (WI),1973-1981,10,10,16,16,0,16,0,3 (3ct 0st),1.6,
47,Naved-ul-Hasan (PAK),2003-2010,71,71,16,16,0,0,16,2 (2ct 0st),0.225,
48,PJ Ongondo (Afr/KENYA),1999-2011,76,76,16,16,0,0,16,2 (2ct 0st),0.21,
49,AL Phehlukwayo (SA),2016-2022,67,67,16,16,0,0,16,2 (2ct 0st),0.238,
0,A Ratra (INDIA),2002-2002,12,12,16,11,5,11,0,3 (2ct 1st),1.333,
1,GJ Rennie (ZIM),1996-2003,39,39,16,16,0,0,16,2 (2ct 0st),0.41,
2,Rohan Mustafa (UAE),2014-2021,39,39,16,16,0,0,16,2 (2ct 0st),0.41,
3,PM Seelaar (NED),2006-2022,49,49,16,16,0,0,16,2 (2ct 0st),0.326,
4,RD Shah (KENYA),1998-2007,55,55,16,16,0,0,16,2 (2ct 0st),0.29,
5,VS Solanki (ENG),2000-2006,49,49,16,16,0,0,16,2 (2ct 0st),0.326,
6,GM Wood (AUS),1978-1989,76,76,16,16,0,0,16,2 (2ct 0st),0.21,
7,Zaheer Abbas (PAK),1974-1985,59,59,16,16,0,0,16,2 (2ct 0st),0.271,
8,Anil Dalpat (PAK),1984-1986,14,14,15,13,2,13,0,3 (3ct 0st),1.071,
9,MA Atherton (ENG),1990-1998,53,53,15,15,0,0,15,2 (2ct 0st),0.283,
10,Basit Ali (PAK),1993-1996,49,49,15,15,0,0,15,2 (2ct 0st),0.306,
11,T Bavuma (SA),2016-2022,14,14,15,15,0,0,15,4 (4ct 0st),1.071,
12,B Bhandari (NEPAL),2019-2021,12,12,15,14,1,14,0,4 (4ct 0st),1.25,
13,SE Bond (NZ),2002-2010,79,79,15,15,0,0,15,2 (2ct 0st),0.189,
14,PS de Villiers (SA),1992-1997,81,81,15,15,0,0,15,2 (2ct 0st),0.185,
15,RL Dias (SL),1979-1987,54,54,15,15,0,0,15,2 (2ct 0st),0.277,
16,ST Finn (ENG),2011-2017,66,66,15,15,0,0,15,2 (2ct 0st),0.227,
17,TJ Friend (ZIM),2000-2004,49,49,15,15,0,0,15,2 (2ct 0st),0.306,
18,RR Hendricks (SA),2018-2021,22,22,15,15,0,0,15,3 (3ct 0st),0.681,
19,MJ Henry (NZ),2014-2021,51,51,15,15,0,0,15,2 (2ct 0st),0.294,
20,DT Hondo (ZIM),2001-2005,52,52,15,15,0,0,15,1 (1ct 0st),0.288,
21,VG Kambli (INDIA),1991-2000,101,101,15,15,0,0,15,1 (1ct 0st),0.148,
22,AN Kervezee (NED),2006-2012,37,37,15,15,0,0,15,3 (3ct 0st),0.405,
23,MD Marshall (WI),1980-1992,132,132,15,15,0,0,15,2 (2ct 0st),0.113,
24,BAW Mendis (SL),2008-2015,83,83,15,15,0,0,15,2 (2ct 0st),0.18,
25,JA Morkel (Afr/SA),2004-2012,58,58,15,15,0,0,15,2 (2ct 0st),0.258,
26,TJ Murtagh (IRE),2012-2019,55,55,15,15,0,0,15,1 (1ct 0st),0.272,
27,Noor Ali Zadran (AFG),2009-2019,49,49,15,15,0,0,15,2 (2ct 0st),0.306,
28,AR Nurse (WI),2016-2019,49,49,15,15,0,0,15,3 (3ct 0st),0.306,
29,AA Obanda (KENYA),2007-2014,46,46,15,15,0,0,15,2 (2ct 0st),0.326,
30,JL Ontong (Afr/SA),2001-2012,27,27,15,15,0,0,15,2 (2ct 0st),0.555,
31,AR Patel (INDIA),2014-2017,36,36,15,15,0,0,15,2 (2ct 0st),0.416,
32,Rizwan Cheema (CAN),2008-2013,32,32,15,15,0,0,15,2 (2ct 0st),0.468,
33,JD Ryder (NZ),2008-2014,45,45,15,15,0,0,15,2 (2ct 0st),0.333,
34,Sohail Tanvir (PAK),2007-2014,60,60,15,15,0,0,15,2 (2ct 0st),0.25,
35,CM Spearman (NZ),1995-2001,50,50,15,15,0,0,15,1 (1ct 0st),0.3,
36,BC Strang (ZIM),1995-2001,48,48,15,15,0,0,15,2 (2ct 0st),0.312,
37,HA Varaiya (KENYA),2006-2014,60,60,15,15,0,0,15,2 (2ct 0st),0.25,
38,CD Wallace (SCOT),2012-2019,26,26,15,13,2,5,8,4 (4ct 0st),0.576,
39,Asad Shafiq (PAK),2010-2017,58,58,14,14,0,0,14,2 (2ct 0st),0.241,
40,EAE Baptiste (WI),1983-1990,43,43,14,14,0,0,14,2 (2ct 0st),0.325,
41,AC Cummins (CAN/WI),1991-2007,74,74,14,14,0,0,14,2 (2ct 0st),0.189,
42,A Dananjaya (SL),2017-2021,37,37,14,14,0,0,14,2 (2ct 0st),0.378,
43,C de Grandhomme (NZ),2012-2020,41,41,14,14,0,0,14,2 (2ct 0st),0.341,
44,SKL de Silva (SL),1997-1997,10,10,14,9,5,9,0,3 (3ct 0st),1.4,
45,K Doriga (PNG),2017-2021,22,22,14,11,3,10,1,4 (3ct 1st),0.636,
46,DW Fleming (AUS),1994-2001,88,88,14,14,0,0,14,1 (1ct 0st),0.159,
47,HA Gomes (WI),1978-1987,82,82,14,14,0,0,14,1 (1ct 0st),0.17,
48,PSP Handscomb (AUS),2017-2019,22,22,14,14,0,5,9,3 (3ct 0st),0.636,
49,HMRKB Herath (SL),2004-2015,67,67,14,14,0,0,14,2 (2ct 0st),0.208,
0,GP Howarth (NZ),1975-1985,65,65,14,14,0,0,14,2 (2ct 0st),0.215,
1,Imran Farhat (PAK),2001-2013,58,58,14,14,0,0,14,1 (1ct 0st),0.241,
2,Mansoor Akhtar (PAK),1980-1990,39,39,14,14,0,0,14,2 (2ct 0st),0.358,
3,LRD Mendis (SL),1975-1989,75,75,14,14,0,0,14,2 (2ct 0st),0.186,
4,AA Mulla (CAN),2006-2009,24,24,14,9,5,4,5,2 (2ct 0st),0.583,
5,SP Narine (WI),2011-2016,65,65,14,14,0,0,14,2 (2ct 0st),0.215,
6,N Pooran (WI),2019-2022,32,32,14,12,2,3,9,2 (1ct 1st),0.437,
7,KOA Powell (WI),2009-2018,44,44,14,14,0,0,14,2 (2ct 0st),0.318,
8,R Powell (WI),2016-2021,35,35,14,14,0,0,14,2 (2ct 0st),0.4,
9,R Rampaul (WI),2003-2015,85,85,14,14,0,0,14,2 (2ct 0st),0.164,
10,JR Ratnayeke (SL),1982-1990,76,76,14,14,0,0,14,2 (2ct 0st),0.184,
11,Shafiqullah (AFG),2009-2018,24,24,14,11,3,8,3,2 (2ct 0st),0.583,
12,Suraj Kumar (OMA),2019-2021,18,18,14,12,2,12,0,3 (1ct 2st),0.777,
13,JC Tredwell (ENG),2010-2015,44,44,14,14,0,0,14,2 (2ct 0st),0.318,
14,IJL Trott (ENG),2009-2013,65,65,14,14,0,0,14,2 (2ct 0st),0.215,
15,TP Ura (PNG),2014-2021,33,33,14,14,0,0,14,2 (2ct 0st),0.424,
16,Yasir Hameed (PAK),2003-2007,56,56,14,14,0,0,14,2 (2ct 0st),0.25,
17,Aminul Islam (BAN),1988-2002,39,39,13,13,0,0,13,2 (2ct 0st),0.333,
18,HK Badani (INDIA),2000-2004,40,40,13,13,0,0,13,2 (2ct 0st),0.325,
19,RL Chase (WI),2017-2022,30,30,13,13,0,0,13,2 (2ct 0st),0.433,
20,PB Dassanayake (SL),1993-1994,14,14,13,9,4,9,0,2 (2ct 0st),0.928,
21,ALF de Mel (SL),1982-1987,53,53,13,13,0,0,13,2 (2ct 0st),0.245,
22,Dhiman Ghosh (BAN),2008-2008,14,14,13,9,4,9,0,4 (4ct 0st),0.928,
23,Farhad Reza (BAN),2006-2011,34,34,13,13,0,0,13,2 (2ct 0st),0.382,
24,MD Gunathilaka (SL),2015-2021,41,41,13,13,0,0,13,2 (2ct 0st),0.317,
25,DA Gunawardene (SL),1998-2006,61,61,13,13,0,0,13,2 (2ct 0st),0.213,
26,AJ Hollioake (ENG),1996-1999,35,35,13,13,0,0,13,3 (3ct 0st),0.371,
27,AS Joseph (WI),2016-2022,38,38,13,13,0,0,13,2 (2ct 0st),0.342,
28,HH Kanitkar (INDIA),1998-2000,31,31,13,13,0,0,13,2 (2ct 0st),0.419,
29,SM Katich (AUS),2001-2006,45,45,13,13,0,0,13,1 (1ct 0st),0.288,
30,UT Khawaja (AUS),2013-2019,39,39,13,13,0,0,13,2 (2ct 0st),0.333,
31,NFI McCallum (SCOT),2006-2011,40,40,13,13,0,0,13,2 (2ct 0st),0.325,
32,R McLaren (SA),2009-2014,51,51,13,13,0,0,13,1 (1ct 0st),0.254,
33,BMAJ Mendis (SL),2010-2019,54,54,13,13,0,0,13,2 (2ct 0st),0.24,
34,Mohsin Khan (PAK),1977-1986,72,72,13,13,0,0,13,2 (2ct 0st),0.18,
35,Nasir Jamshed (PAK),2008-2015,48,48,13,13,0,0,13,2 (2ct 0st),0.27,
36,JS Patel (NZ),2005-2017,42,42,13,13,0,0,13,1 (1ct 0st),0.309,
37,MD Patel (USA),2019-2021,19,19,13,13,0,6,7,2 (2ct 0st),0.684,
38,Shahriar Nafees (BAN),2005-2011,75,75,13,13,0,0,13,2 (2ct 0st),0.173,
39,Shoaib Mohammad (PAK),1984-1993,62,62,13,13,0,0,13,2 (2ct 0st),0.209,
40,DS Smith (WI),2003-2013,45,45,13,13,0,0,13,3 (3ct 0st),0.288,
41,RN ten Doeschate (NED),2006-2011,31,31,13,13,0,0,13,2 (2ct 0st),0.419,
42,HE van der Dussen (SA),2019-2022,29,29,13,13,0,0,13,2 (2ct 0st),0.448,
43,RR Watson (SCOT),2006-2010,32,32,13,13,0,0,13,2 (2ct 0st),0.406,
44,DNT Zoysa (SL),1997-2005,94,94,13,13,0,0,13,2 (2ct 0st),0.138,
45,Akshay Homraj (USA),2019-2020,8,8,12,12,0,12,0,4 (4ct 0st),1.5,
46,CJA Amini (PNG),2014-2021,21,21,12,12,0,0,12,2 (2ct 0st),0.571,
47,Amjad Ali (UAE),2008-2015,17,17,12,11,1,4,7,3 (3ct 0st),0.705,
48,PK Amre (INDIA),1991-1994,36,36,12,12,0,0,12,2 (2ct 0st),0.333,
49,RMH Binny (INDIA),1980-1987,69,69,12,12,0,0,12,2 (2ct 0st),0.173,
0,IR Bishop (WI),1988-1997,82,82,12,12,0,0,12,1 (1ct 0st),0.146,
1,DE Bollinger (AUS),2009-2011,38,38,12,12,0,0,12,1 (1ct 0st),0.315,
2,JM Brearley (ENG),1977-1980,24,24,12,12,0,0,12,2 (2ct 0st),0.5,
3,CD Collymore (WI),1999-2007,78,78,12,12,0,0,12,2 (2ct 0st),0.153,
4,TLW Cooper (NED),2010-2013,23,23,12,12,0,0,12,2 (2ct 0st),0.521,
5,KM Dabengwa (ZIM),2005-2010,37,37,12,12,0,0,12,2 (2ct 0st),0.324,
6,JWM Dalrymple (ENG),2006-2007,26,26,12,12,0,0,12,2 (2ct 0st),0.461,
7,KSC de Silva (SL),1996-2000,36,36,12,12,0,0,12,2 (2ct 0st),0.333,
8,J Dyson (AUS),1980-1983,28,28,12,12,0,0,12,3 (3ct 0st),0.428,
9,BA Edgar (NZ),1978-1986,62,62,12,12,0,0,12,2 (2ct 0st),0.193,
10,CN Evans (ZIM),1992-2002,52,52,12,12,0,0,12,2 (2ct 0st),0.23,
11,NA Foster (ENG),1984-1989,48,48,12,12,0,0,12,2 (2ct 0st),0.25,
12,ZE Green (NAM),2019-2021,10,10,12,10,2,10,0,5 (5ct 0st),1.2,
13,Hasan Ali (PAK),2016-2021,55,55,12,12,0,0,12,2 (2ct 0st),0.218,
14,TM Head (AUS),2016-2018,40,40,12,12,0,0,12,2 (2ct 0st),0.3,
15,MJ Horne (NZ),1997-2002,44,44,12,12,0,0,12,2 (2ct 0st),0.272,
16,Imad Wasim (PAK),2015-2020,54,54,12,12,0,0,12,1 (1ct 0st),0.222,
17,CA Ingram (SA),2010-2013,31,31,12,12,0,0,12,2 (2ct 0st),0.387,
18,Javed Omar (BAN),1995-2007,59,59,12,12,0,0,12,2 (2ct 0st),0.203,
19,MS Kasprowicz (AUS),1995-2005,41,41,12,12,0,0,12,2 (2ct 0st),0.292,
20,SG Law (AUS),1994-1999,54,54,12,12,0,0,12,2 (2ct 0st),0.222,
21,DA Marillier (ZIM),2000-2003,45,45,12,12,0,0,12,2 (2ct 0st),0.266,
22,XM Marshall (USA/WI),2005-2020,36,36,12,12,0,0,12,2 (2ct 0st),0.333,
23,T Maruma (ZIM),2007-2021,22,22,12,12,0,0,12,3 (3ct 0st),0.545,
24,SF Mire (ZIM),2014-2019,47,47,12,12,0,0,12,1 (1ct 0st),0.255,
25,HS Modi (KENYA),1996-2006,61,61,12,12,0,0,12,2 (2ct 0st),0.196,
26,J Mubarak (SL),2002-2013,40,40,12,12,0,0,12,2 (2ct 0st),0.3,
27,HG Munsey (SCOT),2017-2021,30,30,12,12,0,0,12,2 (2ct 0st),0.4,
28,Mustafizur Rahman (BAN),2015-2021,65,65,12,12,0,0,12,2 (2ct 0st),0.184,
29,Nadeem Ahmed (HKG),2004-2018,24,24,12,12,0,0,12,2 (2ct 0st),0.5,
30,HK Olonga (ZIM),1995-2003,47,47,12,12,0,0,12,2 (2ct 0st),0.255,
31,RR Pant (INDIA),2018-2022,20,20,12,11,1,7,4,2 (2ct 0st),0.6,
32,WD Parnell (SA),2009-2017,61,61,12,12,0,0,12,2 (2ct 0st),0.196,
33,DBL Powell (WI),2002-2009,52,52,12,12,0,0,12,2 (2ct 0st),0.23,
34,JA Rennie (ZIM),1993-2000,43,43,12,12,0,0,12,2 (2ct 0st),0.279,
35,Shaiman Anwar (UAE),2014-2019,40,40,12,12,0,0,12,2 (2ct 0st),0.3,
36,SM Sharif (SCOT),2011-2021,45,45,12,12,0,0,12,2 (2ct 0st),0.266,
37,Simi Singh (IRE),2017-2021,30,30,12,12,0,0,12,3 (3ct 0st),0.4,
38,RP Singh (INDIA),2005-2011,55,55,12,12,0,0,12,1 (1ct 0st),0.218,
39,MP Stoinis (AUS),2015-2020,45,45,12,12,0,0,12,1 (1ct 0st),0.266,
40,C White (ENG),1994-2003,50,50,12,12,0,0,12,1 (1ct 0st),0.24,
41,MA Wood (ENG),2015-2021,55,55,12,12,0,0,12,2 (2ct 0st),0.218,
42,A Zampa (AUS),2016-2021,63,63,12,12,0,0,12,1 (1ct 0st),0.19,
43,CJ Anderson (NZ),2013-2017,45,45,11,11,0,0,11,2 (2ct 0st),0.244,
44,Babar Hayat (HKG),2014-2018,21,21,11,11,0,0,11,2 (2ct 0st),0.523,
45,AC Botha (IRE),2006-2011,39,39,11,11,0,0,11,2 (2ct 0st),0.282,
46,EA Brandes (ZIM),1987-1999,59,59,11,11,0,0,11,1 (1ct 0st),0.186,
47,CR Brathwaite (WI),2011-2019,41,41,11,11,0,0,11,1 (1ct 0st),0.268,
48,C Carter (HKG),2015-2018,10,10,11,10,1,9,1,3 (3ct 0st),1.1,
49,R Clarke (ENG),2003-2006,18,18,11,11,0,0,11,3 (3ct 0st),0.611,
0,RDB Croft (ENG),1996-2001,49,49,11,11,0,0,11,1 (1ct 0st),0.224,
1,AC Dale (AUS),1997-2000,30,30,11,11,0,0,11,1 (1ct 0st),0.366,
2,J Edness (BMUDA),2007-2008,11,11,11,7,4,7,0,3 (2ct 1st),1.0,
3,SA Edwards (NED),2018-2022,12,12,11,9,2,9,0,3 (3ct 0st),0.916,
4,D Ganga (WI),1999-2006,34,34,11,11,0,0,11,2 (2ct 0st),0.323,
5,Hashmatullah Shahidi (AFG),2013-2022,43,43,11,11,0,0,11,1 (1ct 0st),0.255,
6,KM Jarvis (ZIM),2009-2019,49,49,11,11,0,0,11,2 (2ct 0st),0.224,
7,Javed Ahmadi (AFG),2010-2021,44,44,11,11,0,0,11,1 (1ct 0st),0.25,
8,FDM Karunaratne (SL),2011-2021,32,32,11,11,0,0,11,1 (1ct 0st),0.343,
9,Khawar Ali (OMA),2019-2021,17,17,11,11,0,0,11,2 (2ct 0st),0.647,
10,PN Kirsten (SA),1991-1994,40,40,11,11,0,0,11,2 (2ct 0st),0.275,
11,P Kumar (INDIA),2007-2012,65,65,11,11,0,0,11,2 (2ct 0st),0.169,
12,RT Latham (NZ),1990-1994,33,33,11,11,0,0,11,2 (2ct 0st),0.333,
13,BJ McCarthy (IRE),2016-2021,37,37,11,11,0,0,11,2 (2ct 0st),0.297,
14,Mohammad Irfan (PAK),2010-2016,60,60,11,11,0,0,11,2 (2ct 0st),0.183,
15,CB Mpofu (ZIM),2004-2020,82,82,11,11,0,0,11,1 (1ct 0st),0.134,
16,BA Murphy (ZIM),2000-2003,30,30,11,11,0,0,11,2 (2ct 0st),0.366,
17,D Murphy (SCOT),2013-2013,8,8,11,8,3,8,0,5 (3ct 2st),1.375,
18,TK Musakanda (ZIM),2016-2018,15,15,11,11,0,0,11,2 (2ct 0st),0.733,
19,P Mustard (ENG),2007-2008,10,10,11,9,2,9,0,2 (2ct 0st),1.1,
20,F Mutizwa (ZIM),2009-2011,17,17,11,9,2,8,1,3 (3ct 0st),0.647,
21,MO Odumbe (KENYA),1996-2003,59,59,11,11,0,0,11,2 (2ct 0st),0.186,
22,H Osinde (CAN),2006-2013,41,41,11,11,0,0,11,2 (2ct 0st),0.268,
23,MM Patel (INDIA),2006-2011,65,65,11,11,0,0,11,2 (2ct 0st),0.169,
24,SM Patil (INDIA),1980-1986,43,43,11,11,0,0,11,2 (2ct 0st),0.255,
25,SP Patil (UAE),2014-2015,13,13,11,8,3,8,0,3 (3ct 0st),0.846,
26,CPH Ramanayake (SL),1986-1995,60,60,11,11,0,0,11,2 (2ct 0st),0.183,
27,RJ Ratnayake (SL),1982-1993,67,67,11,11,0,0,11,2 (2ct 0st),0.164,
28,SJ Rhodes (ENG),1989-1995,9,9,11,9,2,9,0,4 (3ct 1st),1.222,
29,SJ Rixon (AUS),1978-1985,6,6,11,9,2,9,0,4 (2ct 2st),1.833,
30,AD Russell (WI),2011-2019,56,56,11,11,0,0,11,1 (1ct 0st),0.196,
31,Shadab Khan (PAK),2017-2021,47,47,11,11,0,0,11,1 (1ct 0st),0.234,
32,MA Suji (KENYA),1996-2006,62,62,11,11,0,0,11,2 (2ct 0st),0.177,
33,Tahir Naqqash (PAK),1980-1985,36,36,11,11,0,0,11,2 (2ct 0st),0.305,
34,GM Turner (NZ),1973-1983,38,38,11,11,0,0,11,2 (2ct 0st),0.289,
35,DLS van Bunge (NED),2002-2013,35,35,11,11,0,0,11,2 (2ct 0st),0.314,
36,MN van Wyk (SA),2003-2015,17,17,11,10,1,9,1,4 (4ct 0st),0.647,
37,PA Wallace (WI),1991-2000,32,32,11,11,0,0,11,2 (2ct 0st),0.343,
38,MR Whitney (AUS),1983-1993,37,37,11,11,0,0,11,3 (3ct 0st),0.297,
39,Zeeshan Maqsood (OMA),2019-2021,20,20,11,11,0,0,11,2 (2ct 0st),0.55,
40,MR Adair (IRE),2019-2022,22,22,10,10,0,0,10,1 (1ct 0st),0.454,
41,Amir Hamza (AFG),2012-2017,31,31,10,10,0,0,10,2 (2ct 0st),0.322,
42,SD Anurasiri (SL),1986-1994,42,42,10,10,0,0,10,2 (2ct 0st),0.238,
43,Arshad Khan (PAK),1993-2006,57,57,10,10,0,0,10,2 (2ct 0st),0.175,
44,SFAF Bacchus (WI),1978-1983,29,29,10,10,0,0,10,2 (2ct 0st),0.344,
45,L Balaji (INDIA),2002-2009,29,29,10,10,0,0,10,2 (2ct 0st),0.344,
46,S Bau (PNG),2016-2021,28,28,10,10,0,0,10,2 (2ct 0st),0.357,
47,AM Blignaut (ZIM),1999-2010,51,51,10,10,0,0,10,2 (2ct 0st),0.196,
48,BC Broad (ENG),1987-1988,34,34,10,10,0,0,10,1 (1ct 0st),0.294,
49,RP Burl (ZIM),2017-2022,24,24,10,10,0,0,10,2 (2ct 0st),0.416,
0,DT Christian (AUS),2012-2021,20,20,10,10,0,0,10,2 (2ct 0st),0.5,
1,SR Clark (AUS),2005-2009,37,37,10,10,0,0,10,2 (2ct 0st),0.27,
2,JH Davey (SCOT),2010-2019,30,30,10,10,0,0,10,2 (2ct 0st),0.333,
3,SB Doull (NZ),1992-2000,41,41,10,10,0,0,10,2 (2ct 0st),0.243,
4,Fawad Alam (PAK),2007-2015,38,38,10,10,0,0,10,2 (2ct 0st),0.263,
5,LH Ferguson (NZ),2016-2020,36,36,10,10,0,0,10,1 (1ct 0st),0.277,
6,DAS Gunaratne (SL),2016-2019,29,29,10,10,0,0,10,2 (2ct 0st),0.344,
7,RM Haq (SCOT),2006-2015,52,52,10,10,0,0,10,2 (2ct 0st),0.192,
8,SJ Harmison (ENG),2002-2009,55,55,10,10,0,0,10,1 (1ct 0st),0.181,
9,BW Hilfenhaus (AUS),2007-2012,23,23,10,10,0,0,10,2 (2ct 0st),0.434,
10,DW Hookes (AUS),1977-1986,35,35,10,10,0,0,10,2 (2ct 0st),0.285,
11,Iftikhar Anjum (PAK),2004-2010,61,61,10,10,0,0,10,3 (3ct 0st),0.163,
12,Ihsanullah (AFG),2017-2018,16,16,10,10,0,0,10,3 (3ct 0st),0.625,
13,Jatinder Singh (OMA),2019-2021,20,20,10,10,0,0,10,1 (1ct 0st),0.5,
14,LM Jongwe (ZIM),2014-2021,27,27,10,10,0,0,10,3 (3ct 0st),0.37,
15,M Kartik (INDIA),2002-2007,37,37,10,10,0,0,10,1 (1ct 0st),0.27,
16,CK Langeveldt (SA),2001-2010,70,70,10,10,0,0,10,1 (1ct 0st),0.142,
17,RDM Leverock (BMUDA),2006-2009,32,32,10,10,0,0,10,2 (2ct 0st),0.312,
18,DK Lillee (AUS),1972-1983,62,62,10,10,0,0,10,2 (2ct 0st),0.161,
19,DR Lockhart (SCOT),2006-2010,14,14,10,10,0,9,1,3 (3ct 0st),0.714,
20,CR Matthews (SA),1991-1997,55,55,10,10,0,0,10,2 (2ct 0st),0.181,
21,Mohammad Salman (PAK),2011-2011,7,7,10,8,2,8,0,4 (4ct 0st),1.428,
22,DS Mohanty (INDIA),1997-2001,43,43,10,10,0,0,10,2 (2ct 0st),0.232,
23,Muhammad Usman (UAE),2016-2021,35,35,10,10,0,0,10,3 (3ct 0st),0.285,
24,B Muzarabani (ZIM),2018-2022,29,29,10,10,0,0,10,2 (2ct 0st),0.344,
25,RJ Nicol (NZ),2011-2013,20,20,10,10,0,0,10,2 (2ct 0st),0.5,
26,SB O'Connor (NZ),1997-2000,37,37,10,10,0,0,10,2 (2ct 0st),0.27,
27,MK Pandey (INDIA),2015-2021,29,29,10,10,0,0,10,1 (1ct 0st),0.344,
28,JM Parker (NZ),1974-1981,22,22,10,9,1,0,9,3 (3ct 0st),0.454,
29,KMA Paul (WI),2018-2020,19,19,10,10,0,0,10,2 (2ct 0st),0.526,
30,DR Pringle (ENG),1982-1993,43,43,10,10,0,0,10,2 (2ct 0st),0.232,
31,Saleem Elahi (PAK),1995-2004,47,47,10,10,0,0,10,2 (2ct 0st),0.212,
32,Sandeep Goud (OMA),2019-2021,20,20,10,10,0,0,10,2 (2ct 0st),0.5,
33,Shabbir Ahmed (PAK),1999-2005,32,32,10,10,0,0,10,2 (2ct 0st),0.312,
34,L Siaka (PNG),2014-2021,33,33,10,10,0,0,10,2 (2ct 0st),0.303,
35,Sohaib Maqsood (PAK),2013-2021,29,29,10,10,0,0,10,2 (2ct 0st),0.344,
36,Tauseef Ahmed (PAK),1982-1990,67,67,10,10,0,0,10,1 (1ct 0st),0.149,
37,HT Tector (IRE),2020-2022,18,18,10,10,0,0,10,2 (2ct 0st),0.555,
38,KL Tucker (BMUDA),2006-2007,12,12,10,9,1,8,1,4 (4ct 0st),0.833,
39,N Vanua (PNG),2014-2021,29,29,10,10,0,0,10,2 (2ct 0st),0.344,
40,KJ Wadsworth (NZ),1973-1976,10,10,10,8,2,8,0,2 (2ct 0st),1.0,
41,AC Waller (ZIM),1987-1997,37,37,10,10,0,0,10,2 (2ct 0st),0.27,
42,KD Walters (AUS),1971-1981,27,27,10,10,0,0,10,3 (3ct 0st),0.37,
43,CAK Walton (WI),2009-2017,9,9,10,9,1,6,3,4 (4ct 0st),1.111,
44,MH Yardy (ENG),2006-2011,28,28,10,10,0,0,10,2 (2ct 0st),0.357,
45,Yashpal Sharma (INDIA),1978-1985,42,42,10,10,0,0,10,1 (1ct 0st),0.238,
46,FA Allen (WI),2018-2021,16,16,9,9,0,0,9,2 (2ct 0st),0.562,
47,Anamul Haque (BAN),2012-2019,36,36,9,9,0,6,3,3 (3ct 0st),0.25,
48,HMCM Bandara (SL),2006-2010,30,30,9,9,0,0,9,3 (3ct 0st),0.3,
49,SJ Benn (WI),2008-2016,46,46,9,9,0,0,9,1 (1ct 0st),0.195,
0,K Bhurtel (NEPAL),2021-2021,6,6,9,9,0,0,9,3 (3ct 0st),1.5,
1,NT Broom (NZ),2009-2017,36,36,9,9,0,0,9,2 (2ct 0st),0.25,
2,AR Caddick (ENG),1993-2003,53,53,9,9,0,0,9,2 (2ct 0st),0.169,
3,LOB Cann (BMUDA),2006-2009,26,26,9,9,0,0,9,2 (2ct 0st),0.346,
4,RK Chauhan (INDIA),1993-1997,32,32,9,9,0,0,9,1 (1ct 0st),0.281,
5,PP Chawla (INDIA),2007-2011,25,25,9,9,0,0,9,3 (3ct 0st),0.36,
6,SI de Saram (SL),1999-2001,15,15,9,9,0,0,9,2 (2ct 0st),0.6,
7,MA Ealham (ENG),1996-2001,62,62,9,9,0,0,9,1 (1ct 0st),0.145,
8,S Elworthy (SA),1998-2002,37,37,9,9,0,0,9,3 (3ct 0st),0.243,
9,AC Evans (SCOT),2009-2021,37,37,9,9,0,0,9,1 (1ct 0st),0.243,
10,WIA Fernando (SL),2016-2021,25,25,9,9,0,0,9,2 (2ct 0st),0.36,
11,JN Gillespie (AUS),1996-2005,94,94,9,9,0,0,9,1 (1ct 0st),0.095,
12,TG Hogan (AUS),1983-1984,14,14,9,9,0,0,9,2 (2ct 0st),0.642,
13,SS Iyer (INDIA),2017-2022,24,24,9,9,0,0,9,2 (2ct 0st),0.375,
14,IA Karim (KENYA),2011-2014,9,9,9,8,1,5,3,2 (2ct 0st),1.0,
15,CM Kuggeleijn (NZ),1988-1989,16,16,9,9,0,0,9,2 (2ct 0st),0.562,
16,Kuldeep Yadav (INDIA),2017-2021,63,63,9,9,0,0,9,1 (1ct 0st),0.142,
17,R Lamba (INDIA),1986-1989,30,30,9,9,0,0,9,1 (1ct 0st),0.3,
18,NC McGarrell (WI),1998-2001,17,17,9,9,0,0,9,2 (2ct 0st),0.529,
19,RD McCann (IRE),2010-2010,8,8,9,9,0,9,0,3 (3ct 0st),1.125,
20,SS McKechnie (HKG),2017-2018,8,8,9,8,1,7,1,4 (3ct 1st),1.125,
21,Mohammad Wasim (PAK),1996-2000,25,25,9,9,0,0,9,2 (2ct 0st),0.36,
22,CH Morris (SA),2013-2019,40,40,9,9,0,0,9,1 (1ct 0st),0.225,
23,Nizakat Khan (HKG),2014-2018,19,19,9,9,0,0,9,2 (2ct 0st),0.473,
24,SJ Palframan (SA),1996-1996,7,7,9,9,0,9,0,3 (3ct 0st),1.285,
25,T Panyangara (ZIM),2004-2016,64,64,9,9,0,0,9,2 (2ct 0st),0.14,
26,BP Patterson (WI),1986-1993,58,58,9,9,0,0,9,1 (1ct 0st),0.155,
27,AD Poynter (IRE),2008-2014,18,18,9,9,0,0,9,2 (2ct 0st),0.5,
28,Rajin Saleh (BAN),2003-2006,43,43,9,9,0,0,9,2 (2ct 0st),0.209,
29,DA Reeve (ENG),1991-1996,28,28,9,9,0,0,9,2 (2ct 0st),0.321,
30,GM Ritchie (AUS),1982-1987,40,40,9,9,0,0,9,2 (2ct 0st),0.225,
31,JA Rudolph (Afr/SA),2003-2006,42,42,9,9,0,0,9,2 (2ct 0st),0.214,
32,AM Samad (CAN),2003-2009,26,26,9,9,0,0,9,2 (2ct 0st),0.346,
33,Sanwar Hossain (BAN),1998-2003,25,25,9,9,0,0,9,1 (1ct 0st),0.36,
34,JA Simpson (ENG),2021-2021,3,3,9,9,0,9,0,5 (5ct 0st),3.0,
35,MJ Slater (AUS),1993-1997,42,42,9,9,0,0,9,2 (2ct 0st),0.214,
36,RS Sodhi (INDIA),2000-2002,18,18,9,9,0,0,9,2 (2ct 0st),0.5,
37,Sohrawordi Shuvo (BAN),2010-2011,17,17,9,9,0,0,9,2 (2ct 0st),0.529,
38,Taufeeq Umar (PAK),2001-2011,22,22,9,9,0,0,9,1 (1ct 0st),0.409,
39,JR Thomson (AUS),1975-1985,49,49,9,9,0,0,9,2 (2ct 0st),0.183,
40,LL Tsotsobe (SA),2009-2013,59,59,9,9,0,0,9,2 (2ct 0st),0.152,
41,JJ Tucker (BMUDA),2006-2009,26,26,9,9,0,0,9,2 (2ct 0st),0.346,
42,JNT Vare (PNG),2014-2018,9,9,9,6,3,6,0,3 (3ct 0st),1.0,
43,M Vijay (INDIA),2010-2015,17,17,9,9,0,0,9,2 (2ct 0st),0.529,
44,W Watson (NZ),1986-1994,61,61,9,9,0,0,9,1 (1ct 0st),0.147,
45,AR Adams (NZ),2001-2007,41,41,8,8,0,0,8,2 (2ct 0st),0.195,
46,Akram Khan (BAN),1988-2003,44,44,8,8,0,0,8,2 (2ct 0st),0.181,
47,Amjad Javed (UAE),2008-2017,15,15,8,8,0,0,8,1 (1ct 0st),0.533,
48,V Aravind (UAE),2019-2021,8,8,8,7,1,7,0,3 (2ct 1st),1.0,
49,Azhar Ali (PAK),2011-2018,51,51,8,8,0,0,8,1 (1ct 0st),0.156,
0,HS Baidwan (CAN),2008-2014,31,31,8,8,0,0,8,1 (1ct 0st),0.258,
1,GS Ballance (ENG),2013-2015,16,16,8,8,0,0,8,2 (2ct 0st),0.5,
2,D Bau (PNG),2016-2017,10,10,8,6,2,5,1,3 (2ct 1st),0.8,
3,ID Blackwell (ENG),2002-2006,33,33,8,8,0,0,8,2 (2ct 0st),0.242,
4,JAR Blain (SCOT),1999-2009,30,30,8,8,0,0,8,1 (1ct 0st),0.266,
5,IG Butler (NZ),2002-2010,24,24,8,8,0,0,8,2 (2ct 0st),0.333,
6,TM Chappell (AUS),1980-1983,19,19,8,8,0,0,8,2 (2ct 0st),0.421,
7,FRJ Coleman (SCOT),2013-2015,15,15,8,8,0,0,8,3 (3ct 0st),0.533,
8,MD Dai (PNG),2014-2018,18,18,8,8,0,0,8,2 (2ct 0st),0.444,
9,SM Davies (ENG),2009-2011,8,8,8,8,0,8,0,2 (2ct 0st),1.0,
10,N Deonarine (WI),2005-2015,30,30,8,8,0,0,8,2 (2ct 0st),0.266,
11,PWH de Silva (SL),2017-2021,28,28,8,8,0,0,8,2 (2ct 0st),0.285,
12,S Dhaniram (CAN),2006-2010,43,43,8,8,0,0,8,1 (1ct 0st),0.186,
13,Enamul Haque jnr (BAN),2005-2009,10,10,8,8,0,0,8,2 (2ct 0st),0.8,
14,Faheem Ashraf (PAK),2017-2021,29,29,8,8,0,0,8,2 (2ct 0st),0.275,
15,ADS Fletcher (WI),2008-2016,25,25,8,5,3,2,3,3 (1ct 2st),0.32,
16,RM Hogg (AUS),1979-1985,66,66,8,8,0,0,8,1 (1ct 0st),0.121,
17,RIC Holder (WI),1993-1997,37,37,8,8,0,0,8,3 (3ct 0st),0.216,
18,RK Illingworth (ENG),1991-1996,25,25,8,8,0,0,8,2 (2ct 0st),0.32,
19,Imam-ul-Haq (PAK),2017-2021,45,45,8,8,0,0,8,1 (1ct 0st),0.177,
20,BP Julian (AUS),1993-1999,25,25,8,8,0,0,8,2 (2ct 0st),0.32,
21,Junaid Khan (PAK),2011-2019,75,75,8,8,0,0,8,1 (1ct 0st),0.106,
22,AI Kallicharran (WI),1973-1981,31,31,8,8,0,0,8,2 (2ct 0st),0.258,
23,SC Khanna (INDIA),1979-1984,8,8,8,4,4,4,0,3 (1ct 2st),1.0,
24,GF Labrooy (SL),1986-1992,44,44,8,8,0,0,8,1 (1ct 0st),0.181,
25,W Larkins (ENG),1979-1991,23,23,8,8,0,0,8,1 (1ct 0st),0.347,
26,NAM McLean (WI),1996-2003,44,44,8,8,0,0,8,2 (2ct 0st),0.181,
27,JN Malan (SA),2020-2022,12,12,8,8,0,0,8,3 (3ct 0st),0.666,
28,VJ Marks (ENG),1980-1988,34,34,8,8,0,0,8,1 (1ct 0st),0.235,
29,Mirwais Ashraf (AFG),2009-2016,45,45,8,8,0,0,8,2 (2ct 0st),0.177,
30,Mohammad Akram (PAK),1995-2000,21,21,8,8,0,0,8,2 (2ct 0st),0.38,
31,Mohammad Amir (PAK),2009-2019,60,60,8,8,0,0,8,2 (2ct 0st),0.133,
32,S Mukuddem (BMUDA),2006-2007,20,20,8,8,0,0,8,1 (1ct 0st),0.4,
33,AD Mullally (ENG),1996-2001,49,49,8,8,0,0,8,2 (2ct 0st),0.163,
34,T Mupariwa (ZIM),2004-2016,39,39,8,8,0,0,8,1 (1ct 0st),0.205,
35,L Ngidi (SA),2018-2022,31,31,8,8,0,0,8,2 (2ct 0st),0.258,
36,CM Old (ENG),1973-1981,29,29,8,8,0,0,8,2 (2ct 0st),0.275,
37,DR Parry (WI),1978-1980,6,6,8,8,0,0,8,2 (2ct 0st),1.333,
38,EC Rainsford (ZIM),2004-2010,39,39,8,8,0,0,8,2 (2ct 0st),0.205,
39,SLV Raju (INDIA),1990-1996,52,52,8,8,0,0,8,1 (1ct 0st),0.153,
40,MR Ramprakash (ENG),1991-2001,18,18,8,8,0,0,8,2 (2ct 0st),0.444,
41,MJR Rindel (SA),1994-1999,22,22,8,8,0,0,8,2 (2ct 0st),0.363,
42,IH Romaine (BMUDA),2006-2009,35,35,8,8,0,0,8,2 (2ct 0st),0.228,
43,PADLR Sandakan (SL),2016-2021,30,30,8,8,0,0,8,2 (2ct 0st),0.266,
44,Sarfraz Nawaz (PAK),1973-1984,44,44,8,8,0,0,8,1 (1ct 0st),0.181,
45,TL Seifert (NZ),2019-2019,3,3,8,7,1,7,0,4 (4ct 0st),2.666,
46,Shafiul Islam (BAN),2010-2020,60,60,8,8,0,0,8,2 (2ct 0st),0.133,
47,SB Smith (AUS),1983-1985,25,25,8,8,0,0,8,1 (1ct 0st),0.32,
48,IS Sodhi (NZ),2015-2020,31,31,8,8,0,0,8,2 (2ct 0st),0.258,
49,Syed Rasel (BAN),2005-2010,52,52,8,8,0,0,8,2 (2ct 0st),0.153,
0,SW Tait (AUS),2007-2011,33,33,8,8,0,0,8,2 (2ct 0st),0.242,
1,Taskin Ahmed (BAN),2014-2021,39,39,8,8,0,0,8,1 (1ct 0st),0.205,
2,SR Taylor (USA),2019-2021,18,18,8,8,0,0,8,2 (2ct 0st),0.444,
3,SR Thompson (IRE),2013-2017,18,18,8,8,0,0,8,1 (1ct 0st),0.444,
4,MRJ Veletta (AUS),1987-1989,20,20,8,8,0,1,7,3 (3ct 0st),0.4,
5,DM Wellham (AUS),1981-1987,17,17,8,8,0,0,8,2 (2ct 0st),0.47,
6,LR Williams (WI),1996-2001,15,15,8,8,0,0,8,2 (2ct 0st),0.533,
7,KJ Wright (AUS),1979-1979,5,5,8,8,0,8,0,2 (2ct 0st),1.6,
8,CA Young (IRE),2014-2022,30,30,8,8,0,0,8,2 (2ct 0st),0.266,
9,NP Kenjige (USA),2019-2021,11,11,7,7,0,0,7,2 (2ct 0st),0.636,
10,KJ Abbott (SA),2013-2016,27,27,7,7,0,0,7,2 (2ct 0st),0.259,
11,Abdur Rehman (PAK),2006-2014,31,31,7,7,0,0,7,2 (2ct 0st),0.225,
12,PR Adams (SA),1996-2003,23,23,7,7,0,0,7,2 (2ct 0st),0.304,
13,AC Agar (AUS),2015-2021,15,15,7,7,0,0,7,1 (1ct 0st),0.466,
14,Asif Iqbal (PAK),1973-1979,10,10,7,7,0,0,7,2 (2ct 0st),0.7,
15,KBJ Azad (INDIA),1980-1986,23,23,7,7,0,0,7,2 (2ct 0st),0.304,
16,GEF Barnett (CAN),2006-2010,22,22,7,7,0,0,7,1 (1ct 0st),0.318,
17,DE Bernard (WI),2003-2010,19,19,7,7,0,0,7,1 (1ct 0st),0.368,
18,IS Billcliff (CAN),2003-2009,19,19,7,7,0,0,7,2 (2ct 0st),0.368,
19,D Bishoo (WI),2011-2019,40,40,7,7,0,0,7,1 (1ct 0st),0.175,
20,GS Blewett (AUS),1995-1999,32,32,7,7,0,0,7,2 (2ct 0st),0.218,
21,MG Burgess (NZ),1973-1981,24,24,7,7,0,0,7,2 (2ct 0st),0.291,
22,JL Carter (WI),2015-2019,31,31,7,7,0,0,7,2 (2ct 0st),0.225,
23,TL Chatara (ZIM),2013-2022,76,76,7,7,0,0,7,1 (1ct 0st),0.092,
24,NM Coulter-Nile (AUS),2013-2019,32,32,7,7,0,0,7,1 (1ct 0st),0.218,
25,TBM de Leede (NED),1996-2007,28,28,7,7,0,0,7,2 (2ct 0st),0.25,
26,JL Denly (ENG),2009-2020,14,14,7,7,0,0,7,2 (2ct 0st),0.5,
27,AIC Dodemaide (AUS),1988-1993,24,24,7,7,0,0,7,2 (2ct 0st),0.291,
28,MG Erasmus (NAM),2019-2020,8,8,7,7,0,0,7,2 (2ct 0st),0.875,
29,N Pradeep (SL),2012-2022,46,46,7,7,0,0,7,2 (2ct 0st),0.152,
30,SR Gillespie (NZ),1986-1988,19,19,7,7,0,0,7,2 (2ct 0st),0.368,
31,G Goudie (SCOT),2008-2013,16,16,7,7,0,0,7,2 (2ct 0st),0.437,
32,R Gunasekera (CAN),2008-2014,18,18,7,7,0,0,7,2 (2ct 0st),0.388,
33,GM Hamilton (SCOT),1999-2010,36,36,7,6,1,0,6,1 (1ct 0st),0.194,
34,AS Hansra (CAN),2010-2014,23,23,7,7,0,0,7,1 (1ct 0st),0.304,
35,MN Hart (NZ),1994-2002,12,12,7,7,0,0,7,2 (2ct 0st),0.583,
36,DL Hemp (BMUDA),2006-2009,22,22,7,7,0,0,7,3 (3ct 0st),0.318,
37,AG Huckle (ZIM),1997-1999,18,18,7,7,0,0,7,2 (2ct 0st),0.388,
38,Humayun Farhat (PAK),2001-2001,5,5,7,4,3,4,0,3 (3ct 0st),1.4,
39,KAD Hurdle (BMUDA),2006-2007,19,19,7,7,0,0,7,1 (1ct 0st),0.368,
40,Jahurul Islam (BAN),2010-2013,13,13,7,7,0,4,3,3 (3ct 0st),0.538,
41,NG Jones (IRE),2010-2011,14,14,7,7,0,0,7,2 (2ct 0st),0.5,
42,S Randiv (SL),2009-2016,30,30,7,7,0,0,7,1 (1ct 0st),0.233,
43,SHT Kandamby (SL),2004-2014,38,38,7,7,0,0,7,2 (2ct 0st),0.184,
44,P Khadka (NEPAL),2018-2020,10,10,7,7,0,0,7,3 (3ct 0st),0.7,
45,RN Lewis (WI),1997-2009,28,28,7,7,0,0,7,1 (1ct 0st),0.25,
46,NM Lyon (AUS),2012-2019,29,29,7,7,0,0,7,2 (2ct 0st),0.241,
47,CJ McKay (AUS),2009-2014,55,55,7,7,0,0,7,3 (3ct 0st),0.127,
48,Manjural Islam (BAN),1999-2003,32,32,7,7,0,0,7,1 (1ct 0st),0.218,
49,CS Martin (NZ),2001-2008,19,19,7,7,0,0,7,1 (1ct 0st),0.368,
0,SW Masakadza (ZIM),2010-2014,16,16,7,7,0,0,7,3 (3ct 0st),0.437,
1,Mehrab Hossain jnr (BAN),2006-2009,18,18,7,7,0,0,7,1 (1ct 0st),0.388,
2,Mohammad Mithun (BAN),2014-2021,33,33,7,7,0,0,7,2 (2ct 0st),0.212,
3,VV Morea (PNG),2014-2018,13,13,7,7,0,0,7,2 (2ct 0st),0.538,
4,CT Mutombodzi (ZIM),2013-2020,14,14,7,7,0,0,7,3 (3ct 0st),0.5,
5,Naimur Rahman (BAN),1995-2002,28,28,7,7,0,0,7,2 (2ct 0st),0.25,
6,Naseem Khushi (OMA),2020-2021,14,14,7,6,1,5,1,2 (2ct 0st),0.5,
7,SN Netravalkar (USA),2019-2021,19,19,7,7,0,0,7,3 (3ct 0st),0.368,
8,J Nyumbu (ZIM),2014-2015,19,19,7,7,0,0,7,2 (2ct 0st),0.368,
9,NN Odhiambo (KENYA),2006-2014,67,67,7,7,0,0,7,1 (1ct 0st),0.104,
10,PP Ojha (INDIA),2008-2012,18,18,7,7,0,0,7,3 (3ct 0st),0.388,
11,E Otieno (KENYA),2007-2014,25,25,7,7,0,0,7,2 (2ct 0st),0.28,
12,BJ Patel (KENYA),2001-2006,30,30,7,7,0,0,7,1 (1ct 0st),0.233,
13,H Patel (CAN),2009-2013,21,21,7,7,0,0,7,2 (2ct 0st),0.333,
14,N Pokana (PNG),2017-2021,19,19,7,7,0,0,7,3 (3ct 0st),0.368,
15,NS Poonia (SCOT),2006-2009,19,19,7,7,0,0,7,2 (2ct 0st),0.368,
16,S Prasanna (SL),2011-2019,39,39,7,7,0,0,7,1 (1ct 0st),0.179,
17,D Pretorius (SA),2016-2022,23,23,7,7,0,0,7,2 (2ct 0st),0.304,
18,C Pringle (NZ),1990-1995,61,61,7,7,0,0,7,1 (1ct 0st),0.114,
19,SMA Priyanjan (SL),2013-2015,23,23,7,7,0,0,7,1 (1ct 0st),0.304,
20,KR Pushpakumara (SL),1994-1999,29,29,7,7,0,0,7,3 (3ct 0st),0.241,
21,DJ Reekers (NED),2006-2009,18,18,7,7,0,0,7,2 (2ct 0st),0.388,
22,KW Richardson (AUS),2013-2020,25,25,7,7,0,0,7,2 (2ct 0st),0.28,
23,BG Rogers (ZIM),2002-2005,15,15,7,7,0,0,7,1 (1ct 0st),0.466,
24,V Shankar (INDIA),2019-2019,12,12,7,7,0,0,7,1 (1ct 0st),0.583,
25,C Sharma (INDIA),1983-1994,62,62,7,7,0,0,7,1 (1ct 0st),0.112,
26,SK Sharma (INDIA),1988-1990,23,23,7,7,0,0,7,2 (2ct 0st),0.304,
27,M Sheikh (KENYA),1997-2000,21,21,7,7,0,0,7,1 (1ct 0st),0.333,
28,L Sivaramakrishnan (INDIA),1985-1987,16,16,7,7,0,0,7,3 (3ct 0st),0.437,
29,GC Small (ENG),1987-1992,50,50,7,7,0,0,7,2 (2ct 0st),0.14,
30,Sohag Gazi (BAN),2012-2014,18,18,7,7,0,0,7,2 (2ct 0st),0.388,
31,TB Sole (SCOT),2018-2019,10,10,7,7,0,0,7,2 (2ct 0st),0.7,
32,CA Soper (PNG),2016-2021,27,27,7,7,0,0,7,2 (2ct 0st),0.259,
33,S Sreesanth (INDIA),2005-2011,49,49,7,7,0,0,7,1 (1ct 0st),0.142,
34,ES Szwarczynski (NED),2006-2014,39,39,7,7,0,0,7,1 (1ct 0st),0.179,
35,Tapash Baisya (BAN),2002-2007,55,55,7,7,0,0,7,1 (1ct 0st),0.127,
36,CJ Tavare (ENG),1980-1984,29,29,7,7,0,0,7,2 (2ct 0st),0.241,
37,JWA Taylor (ENG),2011-2015,26,26,7,7,0,0,7,3 (3ct 0st),0.269,
38,K Verreynne (SA),2020-2021,7,7,7,7,0,0,7,3 (3ct 0st),1.0,
39,MRJ Watt (SCOT),2016-2021,31,31,7,7,0,0,7,1 (1ct 0st),0.225,
40,DF Watts (SCOT),2006-2011,34,34,7,7,0,0,7,2 (2ct 0st),0.205,
41,VJ Wells (ENG),1999-1999,9,9,7,7,0,0,7,3 (3ct 0st),0.777,
42,Aftab Alam (AFG),2010-2019,27,27,6,6,0,0,6,2 (2ct 0st),0.222,
43,Aqib Ilyas (OMA),2019-2021,16,16,6,6,0,0,6,2 (2ct 0st),0.375,
44,Ashfaq Ahmed (UAE),2018-2019,16,16,6,6,0,0,6,2 (2ct 0st),0.375,
45,Asif Ali (PAK),2018-2021,18,18,6,6,0,0,6,1 (1ct 0st),0.333,
46,M Bhanuka (SL),2019-2021,6,6,6,5,1,5,0,3 (3ct 0st),1.0,
47,IDR Bradshaw (WI),2004-2007,59,59,6,6,0,0,6,1 (1ct 0st),0.101,
48,JP Bray (IRE),2006-2007,14,14,6,6,0,1,5,2 (2ct 0st),0.428,
49,AD Brown (ENG),1996-2001,15,15,6,6,0,0,6,2 (2ct 0st),0.4,
0,DG Brownlie (NZ),2012-2017,15,15,6,6,0,0,6,1 (1ct 0st),0.4,
1,Mudassar Bukhari (NED),2007-2014,44,44,6,6,0,0,6,1 (1ct 0st),0.136,
2,LJ Burger (NAM),2003-2003,6,6,6,6,0,0,6,3 (3ct 0st),1.0,
3,DJ Callaghan (SA),1992-2000,28,28,6,6,0,0,6,2 (2ct 0st),0.214,
4,DJ Capel (ENG),1987-1990,21,21,6,6,0,0,6,2 (2ct 0st),0.285,
5,PVD Chameera (SL),2015-2022,37,37,6,6,0,0,6,1 (1ct 0st),0.162,
6,S Chattergoon (WI),2006-2009,15,15,6,6,0,0,6,2 (2ct 0st),0.4,
7,TS Chisoro (ZIM),2015-2020,20,20,6,6,0,0,6,2 (2ct 0st),0.3,
8,GR Codrington (CAN),2006-2007,17,17,6,6,0,0,6,1 (1ct 0st),0.352,
9,PT Collins (WI),1999-2005,28,28,6,6,0,0,6,1 (1ct 0st),0.214,
10,DG Cork (ENG),1992-2002,31,31,6,6,0,0,6,2 (2ct 0st),0.193,
11,CD Cumming (NZ),2003-2009,13,13,6,6,0,0,6,2 (2ct 0st),0.461,
12,WM Darling (AUS),1978-1982,17,17,6,6,0,0,6,3 (3ct 0st),0.352,
13,TN de Grooth (NED),2006-2013,33,33,6,6,0,0,6,1 (1ct 0st),0.181,
14,CD de Lange (SCOT),2016-2017,11,11,6,6,0,0,6,3 (3ct 0st),0.545,
15,AM de Silva (SL),1986-1993,4,4,6,4,2,4,0,3 (2ct 1st),1.5,
16,EAR de Silva (SL),1986-1992,28,28,6,6,0,0,6,2 (2ct 0st),0.214,
17,T Duffin (ZIM),2006-2007,22,22,6,6,0,0,6,1 (1ct 0st),0.272,
18,PH Edmonds (ENG),1977-1987,28,28,6,6,0,0,6,2 (2ct 0st),0.214,
19,Enamul Haque (BAN),1990-2002,29,29,6,6,0,0,6,3 (3ct 0st),0.206,
20,CJ Ferguson (AUS),2009-2011,28,28,6,6,0,0,6,2 (2ct 0st),0.214,
21,G Fowler (ENG),1983-1986,26,26,6,4,2,2,2,3 (1ct 2st),0.23,
22,AD Gaekwad (INDIA),1975-1987,14,14,6,6,0,0,6,1 (1ct 0st),0.428,
23,MR Gillespie (NZ),2006-2009,29,29,6,6,0,0,6,2 (2ct 0st),0.206,
24,K Gore (USA),2019-2021,16,16,6,6,0,0,6,3 (3ct 0st),0.375,
25,AW Greig (ENG),1972-1977,20,20,6,6,0,0,6,3 (3ct 0st),0.3,
26,Hamza Tariq (CAN),2011-2014,7,7,6,5,1,5,0,2 (2ct 0st),0.857,
27,Hannan Sarkar (BAN),2002-2004,19,19,6,6,0,2,4,1 (1ct 0st),0.315,
28,RJ Harris (AUS),2009-2012,20,20,6,6,0,0,6,1 (1ct 0st),0.3,
29,Harvinder Singh (INDIA),1997-2001,15,15,6,6,0,0,6,1 (1ct 0st),0.4,
30,Hasibul Hossain (BAN),1995-2004,32,32,6,6,0,0,6,2 (2ct 0st),0.187,
31,UC Hathurusingha (SL),1992-1999,32,32,6,6,0,0,6,1 (1ct 0st),0.187,
32,VA Holder (WI),1973-1978,12,12,6,6,0,0,6,1 (1ct 0st),0.5,
33,BC Hollioake (ENG),1997-2002,20,20,6,6,0,0,6,1 (1ct 0st),0.3,
34,MG Hughes (AUS),1988-1993,33,33,6,6,0,0,6,1 (1ct 0st),0.181,
35,Ikram Alikhil (AFG),2019-2019,11,11,6,3,3,3,0,2 (1ct 1st),0.545,
36,Imtiaz Abbasi (UAE),1994-1996,7,7,6,4,2,4,0,2 (2ct 0st),0.857,
37,RC Irani (ENG),1996-2003,29,29,6,6,0,0,6,1 (1ct 0st),0.206,
38,WR James (ZIM),1992-1996,11,11,6,6,0,3,3,2 (2ct 0st),0.545,
39,TP Kamungozi (ZIM),2006-2015,14,14,6,6,0,0,6,2 (2ct 0st),0.428,
40,AY Karim (KENYA),1996-2003,33,33,6,6,0,0,6,1 (1ct 0st),0.181,
41,Karim Sadiq (AFG),2009-2016,24,24,6,6,0,0,6,2 (2ct 0st),0.25,
42,Khurram Khan (UAE),2004-2015,16,16,6,6,0,0,6,2 (2ct 0st),0.375,
43,CL King (WI),1976-1980,18,18,6,6,0,0,6,1 (1ct 0st),0.333,
44,NR Kumar (CAN),2010-2014,15,15,6,6,0,0,6,2 (2ct 0st),0.4,
45,JK Lever (ENG),1976-1982,21,21,6,6,0,0,6,2 (2ct 0st),0.285,
46,PD McGlashan (NZ),2009-2009,3,3,6,6,0,6,0,3 (3ct 0st),2.0,
47,JS Malhotra (USA),2019-2021,11,11,6,5,1,4,1,2 (2ct 0st),0.545,
48,Manjural Islam Rana (BAN),2003-2006,25,25,6,6,0,0,6,1 (1ct 0st),0.24,
49,JJ Martin (INDIA),1999-2001,10,10,6,6,0,0,6,3 (3ct 0st),0.6,
0,WP Masakadza (ZIM),2015-2022,22,22,6,6,0,0,6,2 (2ct 0st),0.272,
1,Mehrab Hossain (BAN),1998-2003,18,18,6,6,0,0,6,2 (2ct 0st),0.333,
2,Mohammad Naveed (UAE),2014-2019,39,39,6,6,0,0,6,1 (1ct 0st),0.153,
3,JFM Morrison (NZ),1975-1983,17,17,6,6,0,0,6,2 (2ct 0st),0.352,
4,Mujeeb Ur Rahman (AFG),2017-2022,45,45,6,6,0,0,6,1 (1ct 0st),0.133,
5,Mushfiqur Rahman (BAN),2000-2004,28,28,6,6,0,0,6,1 (1ct 0st),0.214,
6,MV Nagamootoo (WI),2000-2002,23,23,6,6,0,0,6,1 (1ct 0st),0.26,
7,A Nao (PNG),2017-2019,13,13,6,6,0,0,6,2 (2ct 0st),0.461,
8,Nazmul Hossain (BAN),2004-2012,38,38,6,6,0,0,6,1 (1ct 0st),0.157,
9,JO Ngoche (KENYA),2010-2013,17,17,6,6,0,0,6,1 (1ct 0st),0.352,
10,ML Nkala (ZIM),1998-2006,50,50,6,6,0,0,6,1 (1ct 0st),0.12,
11,AH Omarshah (ZIM),1983-1996,28,28,6,6,0,0,6,2 (2ct 0st),0.214,
12,SD Outerbridge (BMUDA),2006-2009,23,23,6,6,0,0,6,1 (1ct 0st),0.26,
13,LS Pascoe (AUS),1977-1982,29,29,6,6,0,0,6,1 (1ct 0st),0.206,
14,TRO Payne (WI),1984-1987,7,7,6,6,0,2,4,2 (2ct 0st),0.857,
15,VD Philander (SA),2007-2015,28,28,6,6,0,0,6,2 (2ct 0st),0.214,
16,AJ Pycroft (ZIM),1983-1992,20,20,6,6,0,0,6,2 (2ct 0st),0.3,
17,Rahmanullah Gurbaz (AFG),2021-2022,6,6,6,4,2,4,0,2 (2ct 0st),1.0,
18,Rameez Shahzad (UAE),2016-2018,15,15,6,6,0,0,6,1 (1ct 0st),0.4,
19,BA Reid (AUS),1986-1992,59,59,6,6,0,0,6,2 (2ct 0st),0.101,
20,AME Roberts (WI),1975-1983,56,56,6,6,0,0,6,1 (1ct 0st),0.107,
21,RT Robinson (ENG),1984-1988,26,26,6,6,0,0,6,2 (2ct 0st),0.23,
22,FA Rose (WI),1997-2000,26,26,6,6,0,0,6,1 (1ct 0st),0.23,
23,Shabir Noori (AFG),2010-2016,10,10,6,6,0,0,6,2 (2ct 0st),0.6,
24,MD Shanaka (SL),2016-2022,33,33,6,6,0,0,6,1 (1ct 0st),0.181,
25,Sharjeel Khan (PAK),2013-2017,25,25,6,6,0,0,6,1 (1ct 0st),0.24,
26,AK Sharma (INDIA),1988-1993,31,31,6,6,0,0,6,2 (2ct 0st),0.193,
27,MM Sharma (INDIA),2013-2015,25,25,6,6,0,0,6,1 (1ct 0st),0.24,
28,RJ Sidebottom (ENG),2001-2010,25,25,6,6,0,0,6,1 (1ct 0st),0.24,
29,EO Simons (SA),1994-1995,23,23,6,6,0,0,6,1 (1ct 0st),0.26,
30,TAM Siriwardana (SL),2015-2019,25,25,6,6,0,0,6,2 (2ct 0st),0.24,
31,RP Snell (SA),1991-1996,41,41,6,6,0,0,6,1 (1ct 0st),0.146,
32,WF Stelling (NED),2006-2007,13,13,6,6,0,0,6,1 (1ct 0st),0.461,
33,ZE Surkari (CAN),2008-2011,22,22,6,6,0,0,6,1 (1ct 0st),0.272,
34,RML Taylor (SCOT),2013-2016,15,15,6,6,0,0,6,2 (2ct 0st),0.4,
35,Tushar Imran (BAN),2001-2007,40,40,6,6,0,0,6,1 (1ct 0st),0.15,
36,I Udana (SL),2012-2021,21,21,6,6,0,0,6,2 (2ct 0st),0.285,
37,Umar Amin (PAK),2010-2018,16,16,6,6,0,0,6,2 (2ct 0st),0.375,
38,DL Underwood (ENG),1973-1982,25,25,6,6,0,0,6,2 (2ct 0st),0.24,
39,AV Vadher (KENYA),1997-1999,18,18,6,6,0,0,6,2 (2ct 0st),0.333,
40,Y Venugopal Rao (INDIA),2005-2006,16,16,6,6,0,0,6,2 (2ct 0st),0.375,
41,R Vinay Kumar (INDIA),2010-2013,29,29,6,6,0,0,6,2 (2ct 0st),0.206,
42,JM Vince (ENG),2016-2021,17,17,6,6,0,0,6,2 (2ct 0st),0.352,
43,AC Voges (AUS),2007-2013,27,27,6,6,0,0,6,2 (2ct 0st),0.222,
44,MHN Walker (AUS),1974-1981,16,16,6,6,0,0,6,1 (1ct 0st),0.375,
45,Yasir Shah (PAK),2011-2019,24,24,6,6,0,0,6,2 (2ct 0st),0.25,
46,Aasif Sheikh (NEPAL),2021-2021,6,6,5,5,0,1,4,3 (3ct 0st),0.833,
47,Abdul Shakoor (UAE),2015-2018,3,3,5,4,1,2,2,3 (2ct 1st),1.666,
48,GI Allott (NZ),1997-2000,27,27,5,5,0,0,5,1 (1ct 0st),0.185,
49,Anshuman Rath (HKG),2014-2018,17,17,5,5,0,0,5,1 (1ct 0st),0.294,
0,Arafat Sunny (BAN),2014-2015,16,16,5,5,0,0,5,1 (1ct 0st),0.312,
1,JC Archer (ENG),2019-2020,16,16,5,5,0,0,5,1 (1ct 0st),0.312,
2,Arshad Ayub (INDIA),1987-1990,32,32,5,5,0,0,5,1 (1ct 0st),0.156,
3,JT Ball (ENG),2016-2018,18,18,5,5,0,0,5,3 (3ct 0st),0.277,
4,U Bhatti (CAN),2006-2010,35,35,5,5,0,0,5,1 (1ct 0st),0.142,
5,SL Boock (NZ),1978-1987,13,13,5,5,0,0,5,1 (1ct 0st),0.384,
6,G Boycott (ENG),1971-1981,34,34,5,5,0,0,5,3 (3ct 0st),0.147,
7,DH Brain (ZIM),1992-1995,22,22,5,5,0,0,5,2 (2ct 0st),0.227,
8,RD Brown (ZIM),1983-1987,7,7,5,5,0,0,5,2 (2ct 0st),0.714,
9,DE Budge (SCOT),2018-2021,8,8,5,5,0,0,5,2 (2ct 0st),0.625,
10,RJ Campbell (AUS),2002-2002,2,2,5,4,1,4,0,3 (2ct 1st),2.5,
11,IM Chappell (AUS),1971-1980,16,16,5,5,0,0,5,2 (2ct 0st),0.312,
12,PKD Chase (IRE),2016-2018,23,23,5,5,0,0,5,2 (2ct 0st),0.217,
13,NG Cowans (ENG),1983-1985,23,23,5,5,0,0,5,1 (1ct 0st),0.217,
14,CE Cuffy (WI),1994-2002,39,39,5,5,0,0,5,1 (1ct 0st),0.128,
15,TK Curran (ENG),2017-2021,26,26,5,5,0,0,5,1 (1ct 0st),0.192,
16,WW Daniel (WI),1978-1984,18,18,5,5,0,0,5,1 (1ct 0st),0.277,
17,SP Davis (AUS),1986-1988,37,37,5,5,0,0,5,1 (1ct 0st),0.135,
18,MH Dekker (ZIM),1992-1996,22,22,5,5,0,0,5,1 (1ct 0st),0.227,
19,BFW de Leede (NED),2018-2022,10,10,5,5,0,0,5,2 (2ct 0st),0.5,
20,JW Dernbach (ENG),2011-2013,23,23,5,5,0,0,5,2 (2ct 0st),0.217,
21,DS de Silva (SL),1975-1985,40,40,5,5,0,0,5,1 (1ct 0st),0.125,
22,VC Drakes (WI),1995-2004,32,32,5,5,0,0,5,1 (1ct 0st),0.156,
23,GD Drummond (SCOT),2007-2013,28,28,5,5,0,0,5,1 (1ct 0st),0.178,
24,H Durham (BMUDA),2006-2006,9,9,5,5,0,0,5,2 (2ct 0st),0.555,
25,GN Edwards (NZ),1976-1981,6,6,5,5,0,2,3,2 (2ct 0st),0.833,
26,RMS Eranga (SL),2011-2016,18,18,5,5,0,0,5,2 (2ct 0st),0.277,
27,SM Ervine (ZIM),2001-2004,39,39,5,5,0,0,5,1 (1ct 0st),0.128,
28,SE Findlay (WI),2008-2009,8,8,5,5,0,0,5,2 (2ct 0st),0.625,
29,ARC Fraser (ENG),1989-1999,40,40,5,5,0,0,5,1 (1ct 0st),0.125,
30,AFG Griffith (WI),1996-2000,9,9,5,5,0,0,5,2 (2ct 0st),0.555,
31,Hamid Hassan (AFG),2009-2019,37,37,5,5,0,0,5,1 (1ct 0st),0.135,
32,BR Hartland (NZ),1992-1994,15,15,5,5,0,0,5,1 (1ct 0st),0.333,
33,JW Hastings (AUS),2010-2016,28,28,5,5,0,0,5,2 (2ct 0st),0.178,
34,RC Haynes (WI),1989-1991,8,8,5,5,0,0,5,2 (2ct 0st),0.625,
35,EE Hemmings (ENG),1982-1991,31,31,5,5,0,0,5,1 (1ct 0st),0.161,
36,M Hendrick (ENG),1973-1981,19,19,5,5,0,0,5,1 (1ct 0st),0.263,
37,RS Higgins (ZIM),2006-2006,10,10,5,5,0,0,5,1 (1ct 0st),0.5,
38,PJC Hoffmann (SCOT),2006-2007,17,17,5,5,0,0,5,1 (1ct 0st),0.294,
39,MJ Hoggard (ENG),2001-2006,26,26,5,5,0,0,5,1 (1ct 0st),0.192,
40,PJ Hughes (AUS),2013-2014,22,22,5,5,0,2,3,2 (2ct 0st),0.227,
41,RO Hurley (WI),2003-2004,8,8,5,5,0,0,5,2 (2ct 0st),0.625,
42,Iftikhar Ahmed (PAK),2015-2020,7,7,5,5,0,0,5,1 (1ct 0st),0.714,
43,Imran Haider (UAE),2017-2019,20,20,5,5,0,0,5,1 (1ct 0st),0.25,
44,WS Jayantha (SL),2004-2004,17,17,5,5,0,0,5,1 (1ct 0st),0.294,
45,HAPW Jayawardene (SL),2003-2007,6,6,5,4,1,4,0,2 (2ct 0st),0.833,
46,TE Jesty (ENG),1983-1983,10,10,5,5,0,0,5,2 (2ct 0st),0.5,
47,VB John (SL),1982-1987,42,42,5,5,0,0,5,1 (1ct 0st),0.119,
48,MO Jones (BMUDA),2006-2007,12,12,5,5,0,0,5,3 (3ct 0st),0.416,
49,Kaleemullah (OMA),2019-2021,17,17,5,5,0,0,5,2 (2ct 0st),0.294,
0,RJ Kirtley (ENG),2001-2004,10,10,5,5,0,0,5,1 (1ct 0st),0.5,
1,Krishna Chandran (UAE),2014-2016,12,12,5,5,0,0,5,2 (2ct 0st),0.416,
2,BP Kruger (NED),2010-2011,5,5,5,5,0,0,5,3 (3ct 0st),1.0,
3,BM Laird (AUS),1979-1982,23,23,5,5,0,0,5,1 (1ct 0st),0.217,
4,D Langford-Smith (IRE),2006-2008,20,20,5,5,0,0,5,2 (2ct 0st),0.25,
5,DK Liyanage (SL),1993-2001,14,14,5,5,0,0,5,2 (2ct 0st),0.357,
6,NB Mahwire (ZIM),2004-2006,22,22,5,5,0,0,5,2 (2ct 0st),0.227,
7,GI Maiden (SCOT),2010-2011,7,7,5,5,0,5,0,3 (3ct 0st),0.714,
8,G Malla (NEPAL),2018-2021,16,16,5,5,0,0,5,1 (1ct 0st),0.312,
9,GA Manou (AUS),2009-2009,4,4,5,5,0,5,0,3 (3ct 0st),1.25,
10,A Mishra (INDIA),2003-2016,34,34,5,5,0,0,5,1 (1ct 0st),0.147,
11,Mohammad Asif (Asia/PAK),2005-2010,35,35,5,5,0,0,5,2 (2ct 0st),0.142,
12,Mohammad Hussain (PAK),1997-1998,13,13,5,5,0,0,5,2 (2ct 0st),0.384,
13,Mohammad Nawaz (3) (PAK),2016-2021,16,16,5,5,0,0,5,2 (2ct 0st),0.312,
14,Mohammad Tauqir (UAE),2004-2015,11,11,5,5,0,0,5,2 (2ct 0st),0.454,
15,MD Moxon (ENG),1985-1988,8,8,5,5,0,0,5,2 (2ct 0st),0.625,
16,PWA Mulder (SA),2017-2021,12,12,5,5,0,0,5,2 (2ct 0st),0.416,
17,SR Patel (ENG),2008-2013,33,33,5,5,0,0,5,2 (2ct 0st),0.151,
18,AN Petersen (SA),2006-2013,21,21,5,5,0,0,5,1 (1ct 0st),0.238,
19,N Pothas (SA),2000-2000,3,3,5,4,1,4,0,3 (2ct 1st),1.666,
20,Qaiser Ali (CAN),2006-2008,17,17,5,5,0,0,5,2 (2ct 0st),0.294,
21,CG Rackemann (AUS),1983-1991,49,49,5,5,0,0,5,1 (1ct 0st),0.102,
22,JF Reid (NZ),1980-1986,22,22,5,5,0,0,5,1 (1ct 0st),0.227,
23,DM Richards (WI),2009-2010,8,8,5,5,0,0,5,2 (2ct 0st),0.625,
24,Sadiq Mohammad (PAK),1973-1980,19,19,5,5,0,0,5,2 (2ct 0st),0.263,
25,MAR Samarasekera (SL),1983-1994,39,39,5,5,0,0,5,2 (2ct 0st),0.128,
26,BS Sandhu (INDIA),1982-1984,21,21,5,5,0,0,5,1 (1ct 0st),0.238,
27,Shahadat Hossain (BAN),2006-2013,51,51,5,5,0,0,5,1 (1ct 0st),0.098,
28,Shahriar Hossain (BAN),1997-2004,20,20,5,5,0,0,5,1 (1ct 0st),0.25,
29,T Shamsi (SA),2016-2022,30,30,5,5,0,0,5,2 (2ct 0st),0.166,
30,Shapoor Zadran (AFG),2009-2019,44,44,5,5,0,0,5,1 (1ct 0st),0.113,
31,Sharafuddin Ashraf (AFG),2014-2022,19,19,5,5,0,0,5,3 (3ct 0st),0.263,
32,JJ Smit (NAM),2019-2021,10,10,5,5,0,0,5,2 (2ct 0st),0.5,
33,JN Snape (ENG),2001-2002,10,10,5,5,0,0,5,2 (2ct 0st),0.5,
34,ELR Stewart (SA),1993-2002,6,6,5,5,0,5,0,2 (2ct 0st),0.833,
35,MR Swart (NED),2011-2014,11,11,5,5,0,0,5,2 (2ct 0st),0.454,
36,J Theron (SA/USA),2010-2020,13,13,5,5,0,0,5,2 (2ct 0st),0.384,
37,G Toka (PNG),2019-2021,13,13,5,5,0,0,5,2 (2ct 0st),0.384,
38,LP van Troost (NED),2002-2007,22,22,5,5,0,0,5,1 (1ct 0st),0.227,
39,Wajahatullah Wasti (PAK),1999-2000,15,15,5,5,0,0,5,1 (1ct 0st),0.333,
40,BGK Walker (NZ),2000-2002,11,11,5,5,0,0,5,1 (1ct 0st),0.454,
41,B Warnapura (SL),1975-1982,12,12,5,5,0,0,5,2 (2ct 0st),0.416,
42,SR Waters (KENYA),2008-2011,20,20,5,5,0,0,5,2 (2ct 0st),0.25,
43,CG Williams (NAM),2019-2021,10,10,5,5,0,0,5,2 (2ct 0st),0.5,
44,B Wood (ENG),1972-1982,11,11,5,5,0,0,5,2 (2ct 0st),0.454,
45,Ziaur Rahman (BAN),2013-2014,12,12,5,5,0,0,5,1 (1ct 0st),0.416,
46,Aarif Sheikh (NEPAL),2018-2021,12,12,4,4,0,0,4,2 (2ct 0st),0.333,
47,Adnan Mufti (UAE),2017-2018,18,18,4,4,0,0,4,1 (1ct 0st),0.222,
48,Afif Hossain (BAN),2020-2021,7,7,4,4,0,0,4,2 (2ct 0st),0.571,
49,Ahsan Malik (NED),2011-2014,11,11,4,4,0,0,4,2 (2ct 0st),0.363,
0,DS Airee (NEPAL),2018-2020,10,10,4,4,0,0,4,1 (1ct 0st),0.4,
1,Al Sahariar (BAN),1999-2003,27,27,4,4,0,0,4,2 (2ct 0st),0.148,
2,Amir Hayat (UAE),2018-2019,9,9,4,4,0,0,4,1 (1ct 0st),0.444,
3,Anwar Ali (PAK),2013-2016,21,21,4,4,0,0,4,2 (2ct 0st),0.19,
4,J Arun Lal (INDIA),1982-1989,13,13,4,4,0,0,4,1 (1ct 0st),0.307,
5,Atiq-uz-Zaman (PAK),2000-2000,3,3,4,3,1,3,0,3 (3ct 0st),1.333,
6,AM Bacher (SA),1997-2005,12,12,4,4,0,0,4,2 (2ct 0st),0.333,
7,SB Bangar (INDIA),2002-2004,15,15,4,4,0,0,4,2 (2ct 0st),0.266,
8,GD Barlow (ENG),1976-1977,6,6,4,4,0,0,4,2 (2ct 0st),0.666,
9,GJ Batty (ENG),2002-2009,10,10,4,4,0,0,4,2 (2ct 0st),0.4,
10,AC Bedade (INDIA),1994-1994,12,12,4,4,0,0,4,1 (1ct 0st),0.333,
11,BS Bedi (INDIA),1974-1979,10,10,4,4,0,0,4,3 (3ct 0st),0.4,
12,KCG Benjamin (WI),1992-1996,25,25,4,4,0,0,4,2 (2ct 0st),0.16,
13,CA Best (WI),1986-1992,22,22,4,4,0,0,4,2 (2ct 0st),0.181,
14,TL Best (WI),2004-2014,26,26,4,4,0,0,4,1 (1ct 0st),0.153,
15,BR Blair (NZ),1982-1986,13,13,4,4,0,0,4,2 (2ct 0st),0.307,
16,DR Brown (ENG/SCOT),1997-2007,25,25,4,4,0,0,4,1 (1ct 0st),0.16,
17,HR Bryan (WI),1999-1999,14,14,4,4,0,0,4,1 (1ct 0st),0.285,
18,IP Butchart (ZIM),1983-1995,19,19,4,4,0,0,4,1 (1ct 0st),0.21,
19,GD Campbell (AUS),1989-1990,12,12,4,4,0,0,4,1 (1ct 0st),0.333,
20,KED Carroll (IRE),2007-2007,6,6,4,4,0,0,4,2 (2ct 0st),0.666,
21,BB Chari (ZIM),2015-2020,13,13,4,3,1,1,2,2 (1ct 1st),0.307,
22,DN Chudasama (KENYA),1996-1999,19,19,4,4,0,0,4,1 (1ct 0st),0.21,
23,ST Clarke (WI),1978-1982,10,10,4,4,0,0,4,1 (1ct 0st),0.4,
24,GJ Cosier (AUS),1975-1979,8,8,4,4,0,0,4,2 (2ct 0st),0.5,
25,Z Crawley (ENG),2021-2021,3,3,4,4,0,0,4,2 (2ct 0st),1.333,
26,GJ Delany (IRE),2020-2022,12,12,4,4,0,0,4,2 (2ct 0st),0.333,
27,PC de Silva (SL),2014-2017,7,7,4,4,0,0,4,2 (2ct 0st),0.571,
28,GR Dilley (ENG),1979-1988,36,36,4,4,0,0,4,2 (2ct 0st),0.111,
29,FH Edwards (WI),2003-2009,47,47,4,4,0,0,4,1 (1ct 0st),0.085,
30,D Elgar (SA),2012-2018,7,7,4,4,0,0,4,2 (2ct 0st),0.571,
31,FM Engineer (INDIA),1974-1975,5,5,4,3,1,3,0,1 (1ct 0st),0.8,
32,KWR Fletcher (ENG),1971-1982,21,21,4,4,0,0,4,1 (1ct 0st),0.19,
33,PJ Forrest (AUS),2012-2012,14,14,4,4,0,0,4,1 (1ct 0st),0.285,
34,RC Fredericks (WI),1973-1977,12,12,4,4,0,0,4,1 (1ct 0st),0.333,
35,JN Frylinck (NAM),2019-2021,10,10,4,4,0,0,4,2 (2ct 0st),0.4,
36,HJW Gardiner (SCOT),2013-2015,11,11,4,4,0,0,4,2 (2ct 0st),0.363,
37,RS Gavaskar (INDIA),2004-2004,10,10,4,4,0,0,4,2 (2ct 0st),0.4,
38,HM Goonatilleke (SL),1982-1982,6,6,4,0,4,0,0,2 (0ct 2st),0.666,
39,TR Gripper (ZIM),2001-2003,8,8,4,4,0,0,4,2 (2ct 0st),0.5,
40,Hammad Azam (PAK),2011-2015,10,10,4,4,0,0,4,2 (2ct 0st),0.4,
41,Haseeb Amjad (HKG),2014-2016,7,7,4,4,0,0,4,1 (1ct 0st),0.571,
42,BF Hastings (NZ),1973-1975,8,8,4,4,0,0,4,2 (2ct 0st),0.5,
43,M Hayward (SA),1998-2002,21,21,4,4,0,0,4,1 (1ct 0st),0.19,
44,MC Henriques (AUS),2009-2021,13,13,4,4,0,0,4,1 (1ct 0st),0.307,
45,PA Hitchcock (NZ),2002-2008,12,12,4,4,0,0,4,1 (1ct 0st),0.333,
46,AJ Hosein (WI),2021-2022,12,12,4,4,0,0,4,1 (1ct 0st),0.333,
47,EH Hutchinson (USA),2019-2021,11,11,4,4,0,0,4,2 (2ct 0st),0.363,
48,RD Jackman (ENG),1974-1983,15,15,4,4,0,0,4,1 (1ct 0st),0.266,
49,SC Joseph (WI),2000-2005,13,13,4,4,0,0,4,1 (1ct 0st),0.307,
0,BD Julien (WI),1973-1977,12,12,4,4,0,0,4,1 (1ct 0st),0.333,
1,S Jyoti (CAN),2006-2010,13,13,4,4,0,0,4,1 (1ct 0st),0.307,
2,RB Kanhai (WI),1973-1975,7,7,4,4,0,0,4,1 (1ct 0st),0.571,
3,MF Kent (AUS),1981-1981,5,5,4,4,0,0,4,2 (2ct 0st),0.8,
4,RD King (WI),1998-2005,49,49,4,4,0,0,4,1 (1ct 0st),0.081,
5,RK Kleinveldt (SA),2013-2013,10,10,4,4,0,0,4,2 (2ct 0st),0.4,
6,A Kuruvilla (INDIA),1997-1997,22,22,4,4,0,0,4,1 (1ct 0st),0.181,
7,M Labuschagne (AUS),2020-2020,13,13,4,4,0,0,4,2 (2ct 0st),0.307,
8,RP Lefebvre (NED),1996-2003,11,11,4,4,0,0,4,1 (1ct 0st),0.363,
9,KS Lokuarachchi (SL),2003-2007,20,20,4,4,0,0,4,1 (1ct 0st),0.2,
10,RT Lyons (SCOT),2006-2010,24,24,4,4,0,0,4,1 (1ct 0st),0.166,
11,WK McCallan (IRE),2006-2009,36,36,4,4,0,0,4,1 (1ct 0st),0.111,
12,A McGrath (ENG),2003-2004,13,13,4,4,0,0,4,2 (2ct 0st),0.307,
13,MW Machan (SCOT),2013-2016,22,22,4,4,0,0,4,1 (1ct 0st),0.181,
14,AO Malhotra (INDIA),1982-1986,20,20,4,4,0,0,4,1 (1ct 0st),0.2,
15,AA Mallett (AUS),1971-1975,9,9,4,4,0,0,4,1 (1ct 0st),0.444,
16,AD Mascarenhas (ENG),2007-2009,19,19,4,4,0,0,4,2 (2ct 0st),0.21,
17,MJ Mason (NZ),2003-2010,24,24,4,4,0,0,4,1 (1ct 0st),0.166,
18,MP Maynard (ENG),1994-2000,13,13,4,4,0,0,4,1 (1ct 0st),0.307,
19,G Miller (ENG),1977-1984,25,25,4,4,0,0,4,2 (2ct 0st),0.16,
20,Mohammad Saifuddin (BAN),2017-2021,29,29,4,4,0,0,4,1 (1ct 0st),0.137,
21,JN Mohammed (WI),2011-2021,33,33,4,4,0,0,4,1 (1ct 0st),0.121,
22,Mohsin Kamal (PAK),1984-1989,19,19,4,4,0,0,4,1 (1ct 0st),0.21,
23,Mominul Haque (BAN),2012-2018,27,27,4,4,0,0,4,1 (1ct 0st),0.148,
24,SJ Myburgh (NED),2011-2021,17,17,4,4,0,0,4,1 (1ct 0st),0.235,
25,Nasir Jamal (AFG),2014-2018,15,15,4,4,0,0,4,2 (2ct 0st),0.266,
26,C Overton (ENG),2018-2021,4,4,4,4,0,0,4,2 (2ct 0st),1.0,
27,GAHM Parkar (INDIA),1982-1984,7,7,4,4,0,0,4,2 (2ct 0st),0.571,
28,SS Pathirana (SL),2015-2017,17,17,4,4,0,0,4,2 (2ct 0st),0.235,
29,RK Paudel (NEPAL),2018-2021,11,11,4,4,0,0,4,1 (1ct 0st),0.363,
30,ASA Perera (SL),1998-2001,20,20,4,4,0,0,4,2 (2ct 0st),0.2,
31,MJ Petrie (SCOT),2009-2009,4,4,4,3,1,3,0,2 (2ct 0st),1.0,
32,AM Phangiso (SA),2013-2016,21,21,4,4,0,0,4,1 (1ct 0st),0.19,
33,IL Philip (SCOT),1999-1999,3,3,4,4,0,0,4,3 (3ct 0st),1.333,
34,Qasim Umar (PAK),1983-1987,29,29,4,4,0,0,4,1 (1ct 0st),0.137,
35,V Rathour (INDIA),1996-1997,6,6,4,4,0,0,4,2 (2ct 0st),0.666,
36,PWE Rawson (ZIM),1983-1987,10,10,4,4,0,0,4,2 (2ct 0st),0.4,
37,Raza-ur-Rehman (CAN),2013-2014,5,5,4,4,0,0,4,4 (4ct 0st),0.8,
38,V Razdan (INDIA),1989-1990,3,3,4,4,0,0,4,2 (2ct 0st),1.333,
39,JA Richardson (AUS),2018-2020,13,13,4,4,0,0,4,1 (1ct 0st),0.307,
40,MJG Rippon (NED),2013-2018,6,6,4,4,0,0,4,1 (1ct 0st),0.666,
41,RD Robinson (AUS),1977-1977,2,2,4,3,1,3,0,4 (3ct 1st),2.0,
42,RL Sanghvi (INDIA),1998-1998,10,10,4,4,0,0,4,2 (2ct 0st),0.4,
43,Shaheen Shah Afridi (PAK),2018-2021,26,26,4,4,0,0,4,1 (1ct 0st),0.153,
44,Shahid Nazir (PAK),1996-2000,17,17,4,4,0,0,4,1 (1ct 0st),0.235,
45,A Shahzad (ENG),2010-2011,11,11,4,4,0,0,4,2 (2ct 0st),0.363,
46,R Shepherd (WI),2019-2022,10,10,4,4,0,0,4,1 (1ct 0st),0.4,
47,Sikander Bakht (PAK),1977-1989,27,27,4,4,0,0,4,1 (1ct 0st),0.148,
48,RB Simpson (AUS),1978-1978,2,2,4,4,0,0,4,2 (2ct 0st),2.0,
49,GM Strydom (ZIM),2006-2006,11,11,4,4,0,0,4,2 (2ct 0st),0.363,
0,Tareq Aziz (BAN),2002-2004,10,10,4,4,0,0,4,1 (1ct 0st),0.4,
1,R Telemachus (SA),1998-2006,37,37,4,4,0,0,4,1 (1ct 0st),0.108,
2,SN Thakur (INDIA),2017-2022,17,17,4,4,0,0,4,1 (1ct 0st),0.235,
3,S Thuraisingam (CAN),2003-2008,10,10,4,4,0,0,4,2 (2ct 0st),0.4,
4,T Thushara (SL),2008-2010,37,37,4,4,0,0,4,1 (1ct 0st),0.108,
5,DT Tiripano (ZIM),2014-2021,35,35,4,4,0,0,4,1 (1ct 0st),0.114,
6,MK Tiwary (INDIA),2011-2015,10,10,4,4,0,0,4,3 (3ct 0st),0.4,
7,RJW Topley (ENG),2015-2021,13,13,4,4,0,0,4,1 (1ct 0st),0.307,
8,CT Tremlett (ENG),2005-2011,15,15,4,4,0,0,4,1 (1ct 0st),0.266,
9,RJ Trott (BMUDA),2007-2009,11,11,4,4,0,0,4,1 (1ct 0st),0.363,
10,PCR Tufnell (ENG),1990-1997,20,20,4,4,0,0,4,2 (2ct 0st),0.2,
11,AJ Turner (AUS),2019-2021,9,9,4,4,0,0,4,1 (1ct 0st),0.444,
12,Usman Limbada (CAN),2010-2014,11,11,4,4,0,0,4,2 (2ct 0st),0.363,
13,RH Vance (NZ),1988-1989,8,8,4,4,0,0,4,2 (2ct 0st),0.5,
14,RE van der Merwe (NED/SA),2009-2019,15,15,4,4,0,0,4,1 (1ct 0st),0.266,
15,M van Jaarsveld (SA),2002-2004,11,11,4,4,0,0,4,1 (1ct 0st),0.363,
16,M van Schoor (NAM),2003-2003,5,5,4,4,0,4,0,2 (2ct 0st),0.8,
17,JTC Vaughan (NZ),1992-1996,17,17,4,4,0,0,4,1 (1ct 0st),0.235,
18,S Venkataraghavan (INDIA),1974-1983,15,15,4,4,0,0,4,1 (1ct 0st),0.266,
19,R Vijay Bharadwaj (INDIA),1999-2002,10,10,4,4,0,0,4,1 (1ct 0st),0.4,
20,BV Vitori (ZIM),2011-2018,24,24,4,4,0,0,4,1 (1ct 0st),0.166,
21,Waheed Ahmed (UAE),2019-2021,7,7,4,4,0,0,4,1 (1ct 0st),0.571,
22,RM West (IRE),2008-2009,9,9,4,4,0,0,4,1 (1ct 0st),0.444,
23,AGD Wickremasinghe (SL),1992-1993,3,3,4,1,3,1,0,3 (1ct 2st),1.333,
24,P Willey (ENG),1977-1986,26,26,4,4,0,0,4,1 (1ct 0st),0.153,
25,BA Williams (AUS),2002-2004,24,24,4,4,0,0,4,2 (2ct 0st),0.166,
26,JW Wilson (NZ),1993-2005,6,6,4,4,0,0,4,2 (2ct 0st),0.666,
27,GN Yallop (AUS),1978-1984,25,25,4,4,0,0,4,2 (2ct 0st),0.16,
28,Aaron Jones (USA),2019-2021,14,14,3,3,0,0,3,1 (1ct 0st),0.214,
29,Abid Ali (PAK),2019-2020,6,6,3,3,0,0,3,2 (2ct 0st),0.5,
30,CJ Adams (ENG),1998-2000,5,5,3,3,0,0,3,1 (1ct 0st),0.6,
31,Adeel Raja (NED),2002-2011,21,21,3,3,0,0,3,1 (1ct 0st),0.142,
32,Adnan Akmal (PAK),2011-2012,5,5,3,3,0,3,0,1 (1ct 0st),0.6,
33,RG Aga (KENYA),2004-2014,12,12,3,3,0,0,3,1 (1ct 0st),0.25,
34,Aizaz Khan (HKG),2014-2018,18,18,3,3,0,0,3,1 (1ct 0st),0.166,
35,MW Alleyne (ENG),1999-2000,10,10,3,3,0,0,3,1 (1ct 0st),0.3,
36,TR Ambrose (ENG),2008-2008,4,4,3,3,0,3,0,1 (1ct 0st),0.75,
37,J Anderson (IRE),2014-2016,8,8,3,3,0,0,3,2 (2ct 0st),0.375,
38,KJ Arnott (ZIM),1987-1993,13,13,3,3,0,0,3,1 (1ct 0st),0.23,
39,Azeem Hafeez (PAK),1983-1985,14,14,3,3,0,0,3,2 (2ct 0st),0.214,
40,SJ Baard (NAM),2019-2021,10,10,3,3,0,0,3,1 (1ct 0st),0.3,
41,SV Bahutule (INDIA),1997-2003,7,7,3,3,0,0,3,2 (2ct 0st),0.428,
42,WD Balaji Rao (CAN),2008-2011,10,10,3,3,0,0,3,1 (1ct 0st),0.3,
43,KNA Bandara (SL),2021-2021,5,5,3,3,0,0,3,2 (2ct 0st),0.6,
44,ST Banerjee (INDIA),1991-1992,6,6,3,3,0,0,3,1 (1ct 0st),0.5,
45,AB Barath (WI),2010-2012,13,13,3,3,0,0,3,1 (1ct 0st),0.23,
46,OO Bascome (BMUDA),2008-2008,6,6,3,3,0,0,3,1 (1ct 0st),0.5,
47,JP Behrendorff (AUS),2019-2019,11,11,3,3,0,0,3,1 (1ct 0st),0.272,
48,DM Benkenstein (SA),1998-2002,22,22,3,3,0,0,3,1 (1ct 0st),0.136,
49,HK Bennett (NZ),2010-2020,18,18,3,3,0,0,3,1 (1ct 0st),0.166,
0,STR Binny (INDIA),2014-2015,12,12,3,3,0,0,3,2 (2ct 0st),0.25,
1,K Birkenstock (NAM),2019-2021,10,10,3,3,0,0,3,1 (1ct 0st),0.3,
2,RJ Blakey (ENG),1992-1993,3,3,3,2,1,2,0,2 (1ct 1st),1.0,
3,SM Boland (AUS),2016-2016,13,13,3,3,0,0,3,1 (1ct 0st),0.23,
4,LE Bosman (Afr/SA),2006-2010,14,14,3,3,0,0,3,2 (2ct 0st),0.214,
5,DAJ Bracewell (NZ),2011-2019,19,19,3,3,0,0,3,1 (1ct 0st),0.157,
6,KC Brathwaite (WI),2016-2017,10,10,3,3,0,0,3,1 (1ct 0st),0.3,
7,CPS Chauhan (INDIA),1978-1981,7,7,3,3,0,0,3,1 (1ct 0st),0.428,
8,Chirag Suri (UAE),2018-2020,17,17,3,3,0,0,3,1 (1ct 0st),0.176,
9,NE Clarke (NED),1996-1996,5,5,3,3,0,0,3,1 (1ct 0st),0.6,
10,DP Conway (NZ),2021-2021,3,3,3,3,0,0,3,2 (2ct 0st),1.0,
11,D Dasgupta (INDIA),2001-2001,5,5,3,2,1,2,0,1 (1ct 0st),0.6,
12,AG Davies (SCOT),1999-1999,5,5,3,2,1,2,0,2 (1ct 1st),0.6,
13,AP Devcich (NZ),2013-2016,11,11,3,3,0,0,3,1 (1ct 0st),0.272,
14,N Dhamba (OMA),2021-2021,4,4,3,3,0,0,3,2 (2ct 0st),0.75,
15,LHD Dilhara (SL),2005-2013,9,9,3,3,0,0,3,1 (1ct 0st),0.333,
16,DR Doshi (INDIA),1980-1982,15,15,3,3,0,0,3,1 (1ct 0st),0.2,
17,CE Eksteen (SA),1991-1994,6,6,3,3,0,0,3,1 (1ct 0st),0.5,
18,AM Ellis (NZ),2012-2013,14,14,3,3,0,0,3,2 (2ct 0st),0.214,
19,PA Emery (AUS),1994-1994,1,1,3,3,0,3,0,3 (3ct 0st),3.0,
20,JJ Esmeijer (NED),2002-2003,6,6,3,3,0,0,3,2 (2ct 0st),0.5,
21,GM Ewing (ZIM),2004-2005,7,7,3,3,0,0,3,2 (2ct 0st),0.428,
22,Faisal Hossain (BAN),2004-2010,6,6,3,3,0,0,3,1 (1ct 0st),0.5,
23,Faisal Iqbal (PAK),2000-2006,18,18,3,3,0,0,3,1 (1ct 0st),0.166,
24,TCB Fernando (SL),2001-2003,17,17,3,3,0,0,3,2 (2ct 0st),0.176,
25,DR Flynn (NZ),2008-2012,17,17,3,3,0,0,3,1 (1ct 0st),0.176,
26,BT Foakes (ENG),2019-2019,1,1,3,2,1,2,0,3 (2ct 1st),3.0,
27,CR Foggo (BMUDA),2008-2008,4,4,3,3,0,0,3,2 (2ct 0st),0.75,
28,OD Gibson (WI),1995-1997,15,15,3,3,0,0,3,1 (1ct 0st),0.2,
29,DR Gilbert (AUS),1986-1986,12,12,3,3,0,0,3,1 (1ct 0st),0.25,
30,AH Gray (WI),1985-1991,25,25,3,3,0,0,3,1 (1ct 0st),0.12,
31,EJ Gray (NZ),1984-1988,10,10,3,3,0,0,3,2 (2ct 0st),0.3,
32,PW Gunaratne (SL),2002-2003,22,22,3,3,0,0,3,1 (1ct 0st),0.136,
33,Haris Rauf (PAK),2020-2021,8,8,3,3,0,0,3,1 (1ct 0st),0.375,
34,Haroon Rasheed (PAK),1977-1982,12,12,3,3,0,0,3,1 (1ct 0st),0.25,
35,Hazratullah Zazai (AFG),2018-2019,15,15,3,3,0,0,3,1 (1ct 0st),0.2,
36,DW Headley (ENG),1996-1999,13,13,3,3,0,0,3,1 (1ct 0st),0.23,
37,SP Heaney (CAN),2006-2006,4,4,3,3,0,0,3,2 (2ct 0st),0.75,
38,IG Holland (USA),2019-2020,8,8,3,3,0,0,3,2 (2ct 0st),0.375,
39,HJ Howarth (NZ),1973-1975,6,6,3,3,0,0,3,1 (1ct 0st),0.5,
40,PJ Ingram (NZ),2010-2010,7,7,3,3,0,0,3,1 (1ct 0st),0.428,
41,Iqbal Qasim (PAK),1977-1988,15,15,3,3,0,0,3,1 (1ct 0st),0.2,
42,SD Jack (SA),1994-1995,2,2,3,3,0,0,3,2 (2ct 0st),1.5,
43,Joginder Sharma (INDIA),2004-2007,4,4,3,3,0,0,3,1 (1ct 0st),0.75,
44,MA Jones (SCOT),2018-2019,8,8,3,3,0,0,3,1 (1ct 0st),0.375,
45,C Karunaratne (SL),2021-2022,12,12,3,3,0,0,3,1 (1ct 0st),0.25,
46,SKW Kelly (BMUDA),2006-2009,10,10,3,3,0,0,3,1 (1ct 0st),0.3,
47,D Keulder (NAM),2003-2003,6,6,3,3,0,0,3,2 (2ct 0st),0.5,
48,AR Khurasiya (INDIA),1999-2001,12,12,3,3,0,0,3,1 (1ct 0st),0.25,
49,Khurram Chohan (CAN),2009-2014,24,24,3,3,0,0,3,1 (1ct 0st),0.125,
0,Khurram Manzoor (PAK),2008-2009,7,7,3,3,0,0,3,1 (1ct 0st),0.428,
1,BA King (WI),2019-2020,4,4,3,3,0,0,3,1 (1ct 0st),0.75,
2,FJ Klaassen (NED),2018-2022,9,9,3,3,0,0,3,2 (2ct 0st),0.333,
3,LJ Koen (SA),1997-2000,5,5,3,3,0,0,3,2 (2ct 0st),0.6,
4,DB Kotze (NAM),2003-2003,6,6,3,3,0,0,3,1 (1ct 0st),0.5,
5,AP Kuiper (SA),1991-1996,25,25,3,3,0,0,3,1 (1ct 0st),0.12,
6,CBRLS Kumara (SL),2017-2019,13,13,3,3,0,0,3,1 (1ct 0st),0.23,
7,T Kumaran (INDIA),1999-2000,8,8,3,3,0,0,3,1 (1ct 0st),0.375,
8,JL Langer (AUS),1994-1997,8,8,3,2,1,1,1,1 (1ct 0st),0.375,
9,GF Linde (SA),2021-2021,2,2,3,3,0,0,3,2 (2ct 0st),1.5,
10,D Lloyd (ENG),1973-1980,8,8,3,3,0,0,3,1 (1ct 0st),0.375,
11,BP Loots (NED),2010-2011,7,7,3,3,0,0,3,2 (2ct 0st),0.428,
12,CA Lynn (AUS),2017-2018,4,4,3,3,0,0,3,2 (2ct 0st),0.75,
13,MJ McClenaghan (NZ),2013-2016,43,43,3,3,0,0,3,1 (1ct 0st),0.069,
14,RB McCosker (AUS),1975-1982,14,14,3,3,0,0,3,1 (1ct 0st),0.214,
15,AJ McKay (NZ),2010-2012,19,19,3,3,0,0,3,1 (1ct 0st),0.157,
16,W Madhevere (ZIM),2020-2022,13,13,3,3,0,0,3,1 (1ct 0st),0.23,
17,N Madziva (ZIM),2014-2016,12,12,3,3,0,0,3,1 (1ct 0st),0.25,
18,MAWR Madurasinghe (SL),1988-1992,12,12,3,3,0,0,3,1 (1ct 0st),0.25,
19,GT Main (SCOT),2019-2021,5,5,3,3,0,0,3,2 (2ct 0st),0.6,
20,Majid Khan (PAK),1973-1982,23,23,3,3,0,0,3,1 (1ct 0st),0.13,
21,DJ Malan (ENG),2019-2021,6,6,3,3,0,0,3,2 (2ct 0st),0.5,
22,A Martin (WI),2011-2011,9,9,3,3,0,0,3,1 (1ct 0st),0.333,
23,TBA May (AUS),1987-1995,47,47,3,3,0,0,3,2 (2ct 0st),0.063,
24,M Mbangwa (ZIM),1996-2002,28,28,3,3,0,0,3,1 (1ct 0st),0.107,
25,Mohammad Nadeem (OMA),2019-2021,17,17,3,3,0,0,3,1 (1ct 0st),0.176,
26,R Murray (ZIM),2018-2018,5,5,3,3,0,3,0,1 (1ct 0st),0.6,
27,Mushtaq Mohammad (PAK),1973-1978,10,10,3,3,0,0,3,1 (1ct 0st),0.3,
28,JD Nel (SCOT),2006-2010,17,17,3,3,0,0,3,1 (1ct 0st),0.176,
29,P Nissanka (SL),2021-2022,11,11,3,3,0,0,3,1 (1ct 0st),0.272,
30,RAP Nissanka (SL),2001-2003,23,23,3,3,0,0,3,1 (1ct 0st),0.13,
31,Nurul Hasan (BAN),2016-2021,3,3,3,2,1,2,0,3 (2ct 1st),1.0,
32,MP O'Dowd (NED),2019-2021,7,7,3,3,0,0,3,1 (1ct 0st),0.428,
33,EO Odumbe (KENYA),1996-1996,7,7,3,3,0,0,3,1 (1ct 0st),0.428,
34,LN Onyango (KENYA),1996-2014,28,28,3,3,0,0,3,1 (1ct 0st),0.107,
35,ARM Opatha (SL),1975-1979,5,5,3,3,0,0,3,2 (2ct 0st),0.6,
36,MS Panesar (ENG),2007-2007,26,26,3,3,0,0,3,1 (1ct 0st),0.115,
37,MA Parker (SCOT),2010-2010,10,10,3,3,0,0,3,1 (1ct 0st),0.3,
38,NK Patel (USA),2019-2021,14,14,3,3,0,0,3,1 (1ct 0st),0.214,
39,JL Pattinson (AUS),2011-2015,15,15,3,3,0,0,3,1 (1ct 0st),0.2,
40,NO Perry (WI),1999-2000,20,20,3,3,0,0,3,3 (3ct 0st),0.15,
41,RR Powar (INDIA),2004-2007,29,29,3,3,0,0,3,1 (1ct 0st),0.103,
42,KH Prajapati (OMA),2021-2021,5,5,3,3,0,0,3,1 (1ct 0st),0.6,
43,MR Pydanna (WI),1980-1983,3,3,3,2,1,2,0,1 (1ct 0st),1.0,
44,S Ramesh (INDIA),1999-1999,23,23,3,3,0,0,3,1 (1ct 0st),0.13,
45,SHA Rance (NZ),2017-2017,2,2,3,3,0,0,3,3 (3ct 0st),1.5,
46,Rashid Khan (PAK),1980-1985,26,26,3,3,0,0,3,1 (1ct 0st),0.115,
47,AJ Redmond (NZ),2009-2010,6,6,3,3,0,0,3,1 (1ct 0st),0.5,
48,RB Reid (NZ),1988-1991,9,9,3,3,0,0,3,1 (1ct 0st),0.333,
49,FL Reifer (WI),1997-2009,8,8,3,3,0,0,3,1 (1ct 0st),0.375,
0,CP Rizwan (UAE),2019-2021,11,11,3,3,0,0,3,1 (1ct 0st),0.272,
1,GR Robertson (AUS),1994-1998,13,13,3,3,0,0,3,1 (1ct 0st),0.23,
2,DB Rundle (SA),1994-1994,2,2,3,3,0,0,3,2 (2ct 0st),1.5,
3,NA Saini (INDIA),2019-2021,8,8,3,3,0,0,3,2 (2ct 0st),0.375,
4,Saleem Jaffar (PAK),1986-1990,39,39,3,3,0,0,3,1 (1ct 0st),0.076,
5,DP Samaraweera (SL),1993-1994,5,5,3,3,0,0,3,2 (2ct 0st),0.6,
6,MMC Schewe (NED),1996-1996,5,5,3,2,1,2,0,3 (2ct 1st),0.6,
7,E Schiferli (NED),2002-2013,29,29,3,3,0,0,3,1 (1ct 0st),0.103,
8,Shamsur Rahman (BAN),2013-2014,10,10,3,3,0,0,3,2 (2ct 0st),0.3,
9,KV Sharma (INDIA),2014-2014,2,2,3,3,0,0,3,2 (2ct 0st),1.5,
10,VRV Singh (INDIA),2006-2006,2,2,3,3,0,0,3,2 (2ct 0st),1.5,
11,TT Smart (HKG),2004-2004,2,2,3,3,0,2,1,2 (2ct 0st),1.5,
12,CJ Smith (BMUDA),2006-2007,12,12,3,3,0,0,3,2 (2ct 0st),0.25,
13,JT Smuts (SA),2020-2021,5,5,3,3,0,0,3,2 (2ct 0st),0.6,
14,S Snater (NED),2018-2018,2,2,3,3,0,0,3,2 (2ct 0st),1.5,
15,Sohail Khan (PAK),2008-2016,13,13,3,3,0,0,3,1 (1ct 0st),0.23,
16,CB Sole (SCOT),2016-2021,11,11,3,3,0,0,3,2 (2ct 0st),0.272,
17,MC Sorensen (IRE),2013-2016,12,12,3,3,0,0,3,1 (1ct 0st),0.25,
18,DA Stirling (NZ),1984-1984,6,6,3,3,0,0,3,1 (1ct 0st),0.5,
19,PC Strydom (SA),2000-2000,10,10,3,3,0,0,3,2 (2ct 0st),0.3,
20,R Strydom (IRE),2008-2008,8,8,3,3,0,0,3,1 (1ct 0st),0.375,
21,Tanveer Ahmed (HKG),2016-2018,5,5,3,3,0,0,3,2 (2ct 0st),0.6,
22,Tanwir Afzal (HKG),2014-2018,19,19,3,3,0,0,3,1 (1ct 0st),0.157,
23,APB Tennekoon (SL),1975-1979,4,4,3,3,0,0,3,1 (1ct 0st),0.75,
24,AJ Traicos (ZIM),1983-1993,27,27,3,3,0,0,3,1 (1ct 0st),0.111,
25,A Turner (AUS),1975-1975,6,6,3,3,0,0,3,2 (2ct 0st),0.5,
26,Usman Ghani (AFG),2014-2022,17,17,3,3,0,0,3,1 (1ct 0st),0.176,
27,Usman Shinwari (PAK),2017-2019,17,17,3,3,0,0,3,2 (2ct 0st),0.176,
28,LV van Beek (NED),2021-2021,5,5,3,3,0,0,3,2 (2ct 0st),0.6,
29,JDF Vandersay (SL),2015-2022,13,13,3,3,0,0,3,1 (1ct 0st),0.23,
30,JJ van der Wath (SA),2006-2007,10,10,3,3,0,0,3,1 (1ct 0st),0.3,
31,GR Viswanath (INDIA),1974-1982,25,25,3,3,0,0,3,1 (1ct 0st),0.12,
32,Waqas Barkat (HKG),2014-2018,10,10,3,3,0,0,3,1 (1ct 0st),0.3,
33,SM Warnapura (SL),2007-2008,3,3,3,3,0,0,3,2 (2ct 0st),1.0,
34,PN Webb (NZ),1983-1984,5,5,3,3,0,3,0,1 (1ct 0st),0.6,
35,K Weeraratne (SL),2000-2008,14,14,3,3,0,0,3,1 (1ct 0st),0.214,
36,DS Wesonga (KENYA),2010-2011,4,4,3,3,0,0,3,2 (2ct 0st),0.75,
37,S Wettimuny (SL),1982-1987,33,33,3,3,0,0,3,1 (1ct 0st),0.09,
38,BTJ Wheal (SCOT),2016-2019,12,12,3,3,0,0,3,1 (1ct 0st),0.25,
39,SG Whittingham (SCOT),2017-2019,5,5,3,3,0,0,3,1 (1ct 0st),0.6,
40,KIW Wijegunawardene (SL),1988-1992,25,25,3,3,0,0,3,1 (1ct 0st),0.12,
41,RA Woolmer (ENG),1972-1976,6,6,3,3,0,0,3,1 (1ct 0st),0.5,
42,Jai P Yadav (INDIA),2002-2005,12,12,3,3,0,0,3,2 (2ct 0st),0.25,
43,Yamin Ahmadzai (AFG),2015-2022,6,6,3,3,0,0,3,1 (1ct 0st),0.5,
44,Zahoor Khan (UAE),2017-2021,19,19,3,3,0,0,3,1 (1ct 0st),0.157,
45,M Zondeki (Afr/SA),2002-2008,12,12,3,3,0,0,3,1 (1ct 0st),0.25,
46,Aamir Kaleem (OMA),2019-2019,2,2,2,2,0,0,2,1 (1ct 0st),1.0,
47,Abdur Rauf (PAK),2008-2008,4,4,2,2,0,0,2,1 (1ct 0st),0.5,
48,MA Agarwal (INDIA),2020-2020,5,5,2,2,0,0,2,1 (1ct 0st),0.4,
49,Aizaz Cheema (PAK),2011-2012,14,14,2,2,0,0,2,1 (1ct 0st),0.142,
0,PJW Allott (ENG),1982-1985,13,13,2,2,0,0,2,1 (1ct 0st),0.153,
1,SW Ambris (WI),2017-2021,16,16,2,2,0,0,2,1 (1ct 0st),0.125,
2,DL Amiss (ENG),1972-1977,16,16,2,2,0,0,2,1 (1ct 0st),0.125,
3,JO Angara (KENYA),1997-2003,16,16,2,2,0,0,2,1 (1ct 0st),0.125,
4,SA Ankola (INDIA),1989-1997,19,19,2,2,0,0,2,1 (1ct 0st),0.105,
5,GG Arnold (ENG),1972-1975,12,12,2,2,0,0,2,1 (1ct 0st),0.166,
6,TD Astle (NZ),2017-2019,9,9,2,2,0,0,2,1 (1ct 0st),0.222,
7,Athar Ali Khan (BAN),1988-1998,19,19,2,2,0,0,2,1 (1ct 0st),0.105,
8,Ayaan Khan (OMA),2021-2021,9,9,2,2,0,0,2,1 (1ct 0st),0.222,
9,Azam Khan (PAK),1996-1998,6,6,2,2,0,0,2,1 (1ct 0st),0.333,
10,Azhar Hossain (BAN),1988-1990,7,7,2,2,0,0,2,1 (1ct 0st),0.285,
11,Azhar Saeed (UAE),1994-1996,7,7,2,2,0,0,2,1 (1ct 0st),0.285,
12,Badal Singh (OMA),2020-2020,2,2,2,2,0,0,2,2 (2ct 0st),1.0,
13,S Badrinath (INDIA),2008-2011,7,7,2,2,0,0,2,2 (2ct 0st),0.285,
14,T Banton (ENG),2020-2020,5,5,2,2,0,0,2,1 (1ct 0st),0.4,
15,IPP Batuwitarachchi (UAE),2008-2008,2,2,2,2,0,0,2,2 (2ct 0st),1.0,
16,AR Berenger (UAE),2014-2015,10,10,2,2,0,0,2,1 (1ct 0st),0.2,
17,S Bhari (NEPAL),2020-2021,9,9,2,2,0,0,2,2 (2ct 0st),0.222,
18,RA Bhatti (CAN),2011-2011,1,1,2,2,0,2,0,2 (2ct 0st),2.0,
19,RL Bhudia (KENYA),2008-2009,5,5,2,2,0,0,2,1 (1ct 0st),0.4,
20,MP Bicknell (ENG),1990-1991,7,7,2,2,0,0,2,1 (1ct 0st),0.285,
21,Bilal Asif (PAK),2015-2015,3,3,2,2,0,0,2,2 (2ct 0st),0.666,
22,Bilawal Bhatti (PAK),2013-2015,10,10,2,2,0,0,2,1 (1ct 0st),0.2,
23,DCC Borden (BMUDA),2006-2008,12,12,2,2,0,0,2,1 (1ct 0st),0.166,
24,GE Bradburn (NZ),1990-2001,10,10,2,2,0,0,2,1 (1ct 0st),0.2,
25,RJ Bright (AUS),1974-1986,11,11,2,2,0,0,2,1 (1ct 0st),0.181,
26,VR Brown (NZ),1988-1988,3,3,2,2,0,0,2,1 (1ct 0st),0.666,
27,PA Browne (WI),2008-2008,5,5,2,2,0,2,0,1 (1ct 0st),0.4,
28,MG Burmester (ZIM),1992-1995,8,8,2,2,0,0,2,1 (1ct 0st),0.25,
29,JA Burns (AUS),2015-2015,6,6,2,2,0,0,2,1 (1ct 0st),0.333,
30,IW Callen (AUS),1978-1982,4,4,2,2,0,0,2,1 (1ct 0st),0.5,
31,J Cameron-Dow (IRE),2019-2019,3,3,2,2,0,0,2,1 (1ct 0st),0.666,
32,C Campher (IRE),2020-2022,13,13,2,2,0,0,2,1 (1ct 0st),0.153,
33,MA Carberry (ENG),2013-2014,5,5,2,2,0,0,2,1 (1ct 0st),0.4,
34,JJ Celestine (BMUDA),2007-2008,8,8,2,2,0,0,2,1 (1ct 0st),0.25,
35,DR Chumney (CAN),2003-2007,21,21,2,2,0,0,2,1 (1ct 0st),0.095,
36,PG Coman (NZ),1973-1974,3,3,2,2,0,0,2,1 (1ct 0st),0.666,
37,G Cook (ENG),1981-1983,6,6,2,2,0,0,2,1 (1ct 0st),0.333,
38,NGB Cook (ENG),1984-1989,3,3,2,2,0,0,2,1 (1ct 0st),0.666,
39,BN Cooper (NED),2013-2021,12,12,2,2,0,0,2,1 (1ct 0st),0.166,
40,JP Crawley (ENG),1994-1999,13,13,2,1,1,0,1,1 (1ct 0st),0.153,
41,DJ Cullen (AUS),2006-2006,5,5,2,2,0,0,2,1 (1ct 0st),0.4,
42,SM Curran (ENG),2018-2021,9,9,2,2,0,0,2,1 (1ct 0st),0.222,
43,Danish Kaneria (PAK),2001-2007,18,18,2,2,0,0,2,1 (1ct 0st),0.111,
44,HT Davis (NZ),1994-1997,11,11,2,2,0,0,2,1 (1ct 0st),0.181,
45,J Da Silva (WI),2021-2021,2,2,2,1,1,1,0,1 (1ct 0st),1.0,
46,RP de Groen (NZ),1993-1994,10,10,2,2,0,0,2,1 (1ct 0st),0.2,
47,PA Desai (CAN),2010-2014,13,13,2,2,0,0,2,1 (1ct 0st),0.153,
48,GRA de Silva (SL),1975-1982,6,6,2,2,0,0,2,1 (1ct 0st),0.333,
49,MW Douglas (NZ),1994-1995,6,6,2,2,0,0,2,1 (1ct 0st),0.333,
0,TM Dowlin (WI),2009-2010,10,10,2,2,0,0,2,1 (1ct 0st),0.2,
1,KG Duers (ZIM),1992-1992,6,6,2,2,0,0,2,1 (1ct 0st),0.333,
2,SF Dukanwala (UAE),1996-1996,5,5,2,2,0,0,2,1 (1ct 0st),0.4,
3,CI Dunusinghe (SL),1995-1995,1,1,2,1,1,1,0,2 (1ct 1st),2.0,
4,MD du Preez (NAM),2021-2021,1,1,2,2,0,0,2,2 (2ct 0st),2.0,
5,NR Dyer (SCOT),1999-1999,5,5,2,2,0,0,2,1 (1ct 0st),0.4,
6,KA Edwards (WI),2011-2014,16,16,2,2,0,0,2,1 (1ct 0st),0.125,
7,Ehsan Khan (HKG),2016-2018,14,14,2,2,0,0,2,2 (2ct 0st),0.142,
8,Ehsan Nawaz (HKG),2014-2018,12,12,2,2,0,0,2,1 (1ct 0st),0.166,
9,RM Ellison (ENG),1984-1986,14,14,2,2,0,0,2,2 (2ct 0st),0.142,
10,EA Essop-Adam (ZIM),1992-1992,1,1,2,2,0,0,2,2 (2ct 0st),2.0,
11,Fahim Muntasir (BAN),2001-2002,3,3,2,2,0,0,2,1 (1ct 0st),0.666,
12,Fareed Ahmad (AFG),2014-2022,6,6,2,2,0,0,2,1 (1ct 0st),0.333,
13,Faruk Ahmed (BAN),1988-1999,7,7,2,2,0,0,2,1 (1ct 0st),0.285,
14,Fayyaz Butt (OMA),2019-2019,5,5,2,2,0,0,2,1 (1ct 0st),0.4,
15,KHRK Fernando (SL),2002-2006,7,7,2,2,0,0,2,1 (1ct 0st),0.285,
16,AN French (HKG),2004-2004,2,2,2,2,0,0,2,1 (1ct 0st),1.0,
17,D Gamage (SL),2003-2003,3,3,2,2,0,0,2,1 (1ct 0st),0.666,
18,JC Gamage (SL),1995-1995,4,4,2,2,0,0,2,1 (1ct 0st),0.5,
19,PLS Gamage (SL),2014-2017,9,9,2,2,0,0,2,1 (1ct 0st),0.222,
20,KD Ghavri (INDIA),1975-1981,19,19,2,2,0,0,2,1 (1ct 0st),0.105,
21,GJ Gilmour (AUS),1974-1975,5,5,2,2,0,0,2,1 (1ct 0st),0.4,
22,BD Glover (NED),2019-2022,5,5,2,2,0,0,2,1 (1ct 0st),0.4,
23,DM Gondaria (KENYA),2013-2013,2,2,2,2,0,0,2,1 (1ct 0st),1.0,
24,TG Gordon (CAN),2011-2011,5,5,2,2,0,0,2,1 (1ct 0st),0.4,
25,Z Groenewald (NAM),2019-2019,4,4,2,2,0,0,2,1 (1ct 0st),0.5,
26,TGJ Gruijters (NED),2010-2013,5,5,2,2,0,0,2,1 (1ct 0st),0.4,
27,DR Hadlee (NZ),1973-1976,9,9,2,2,0,0,2,1 (1ct 0st),0.222,
28,Hafizur Rahman (BAN),1986-1986,2,2,2,2,0,2,0,1 (1ct 0st),1.0,
29,PL Harris (SA),2008-2008,3,3,2,2,0,0,2,1 (1ct 0st),0.666,
30,C Hemraj (WI),2018-2018,6,6,2,2,0,0,2,2 (2ct 0st),0.333,
31,BE Hendricks (SA),2019-2021,6,6,2,2,0,0,2,1 (1ct 0st),0.333,
32,ND Hirwani (INDIA),1988-1992,18,18,2,2,0,0,2,1 (1ct 0st),0.111,
33,LG Howell (NZ),1998-1998,12,12,2,2,0,0,2,1 (1ct 0st),0.166,
34,GW Humpage (ENG),1981-1981,3,3,2,2,0,2,0,1 (1ct 0st),0.666,
35,N Ifill (CAN),2003-2006,4,4,2,2,0,0,2,1 (1ct 0st),0.5,
36,Ijaz Faqih (PAK),1980-1988,27,27,2,2,0,0,2,1 (1ct 0st),0.074,
37,IT Iqbal (KENYA),1996-1996,2,2,2,2,0,2,0,2 (2ct 0st),1.0,
38,AJ Ireland (ZIM),2005-2007,25,25,2,2,0,0,2,1 (1ct 0st),0.08,
39,Irfan Ahmed (HKG),2008-2014,6,6,2,2,0,0,2,2 (2ct 0st),0.333,
40,Ishan Kishan (INDIA),2021-2021,2,2,2,2,0,2,0,1 (1ct 0st),1.0,
41,KA Jamieson (NZ),2020-2021,5,5,2,2,0,0,2,2 (2ct 0st),0.4,
42,PA Jaques (AUS),2006-2007,5,5,2,2,0,0,2,1 (1ct 0st),0.4,
43,Jasdeep Singh (USA),2019-2021,6,6,2,2,0,0,2,2 (2ct 0st),0.333,
44,LR Johnson (WI),2008-2015,6,6,2,2,0,0,2,1 (1ct 0st),0.333,
45,Junaid Siddiqui (CAN),2011-2014,8,8,2,2,0,0,2,1 (1ct 0st),0.25,
46,SMS Kaluperuma (SL),1988-1988,2,2,2,2,0,0,2,1 (1ct 0st),1.0,
47,J Kila (PNG),2018-2021,12,12,2,2,0,0,2,1 (1ct 0st),0.166,
48,JJ Krejza (AUS),2011-2011,7,7,2,2,0,0,2,1 (1ct 0st),0.285,
49,P Krishnamurthy (INDIA),1976-1976,1,1,2,1,1,1,0,2 (1ct 1st),2.0,
0,N Kruger (NED),2011-2011,2,2,2,2,0,0,2,2 (2ct 0st),1.0,
1,DS Kulkarni (INDIA),2014-2016,12,12,2,2,0,0,2,1 (1ct 0st),0.166,
2,RR Kulkarni (INDIA),1983-1987,10,10,2,2,0,0,2,1 (1ct 0st),0.2,
3,Kushal Malla (NEPAL),2020-2021,8,8,2,2,0,0,2,2 (2ct 0st),0.25,
4,S Lamichhane (NEPAL),2018-2021,16,16,2,2,0,0,2,1 (1ct 0st),0.125,
5,B Laughlin (AUS),2009-2009,5,5,2,2,0,0,2,1 (1ct 0st),0.4,
6,P Lever (ENG),1971-1975,8,8,2,2,0,0,2,1 (1ct 0st),0.25,
7,GD Lloyd (ENG),1996-1998,6,6,2,2,0,0,2,1 (1ct 0st),0.333,
8,SCG MacGill (AUS),2000-2000,3,3,2,2,0,0,2,1 (1ct 0st),0.666,
9,BJ McKechnie (NZ),1975-1981,13,13,2,2,0,0,2,1 (1ct 0st),0.153,
10,KH MacLeay (AUS),1983-1987,15,15,2,2,0,0,2,1 (1ct 0st),0.133,
11,TN Madondo (ZIM),1998-2001,12,12,2,2,0,0,2,1 (1ct 0st),0.166,
12,SSB Magala (SA),2022-2022,2,2,2,2,0,0,2,1 (1ct 0st),1.0,
13,JN Maguire (AUS),1983-1984,18,18,2,2,0,0,2,1 (1ct 0st),0.111,
14,I Maraj (CAN),2003-2003,6,6,2,2,0,0,2,1 (1ct 0st),0.333,
15,A Maregwede (ZIM),2003-2005,11,11,2,2,0,0,2,1 (1ct 0st),0.181,
16,EH Mattis (WI),1981-1981,2,2,2,2,0,0,2,1 (1ct 0st),1.0,
17,B Mavuta (ZIM),2018-2019,7,7,2,2,0,0,2,1 (1ct 0st),0.285,
18,TMK Mawoyo (ZIM),2006-2014,7,7,2,2,0,0,2,1 (1ct 0st),0.285,
19,JA McCollum (IRE),2019-2021,10,10,2,2,0,0,2,1 (1ct 0st),0.2,
20,MC Mendis (SL),1995-1995,1,1,2,2,0,0,2,2 (2ct 0st),2.0,
21,PHKD Mendis (SL),2019-2022,7,7,2,2,0,0,2,2 (2ct 0st),0.285,
22,Minhajul Abedin (BAN),1986-1999,27,27,2,2,0,0,2,1 (1ct 0st),0.074,
23,Mohammad Hasnain (PAK),2019-2021,8,8,2,2,0,0,2,1 (1ct 0st),0.25,
24,Mohammad Kashif (NED),2006-2010,10,10,2,2,0,0,2,1 (1ct 0st),0.2,
25,Mohammad Khalil (PAK),2005-2005,3,3,2,2,0,0,2,1 (1ct 0st),0.666,
26,Mohammad Naim (BAN),2020-2021,2,2,2,2,0,0,2,2 (2ct 0st),1.0,
27,Mohammad Shahzad (UAE),2014-2016,6,6,2,2,0,0,2,1 (1ct 0st),0.333,
28,Mohammed Qasim (UAE),2017-2017,5,5,2,2,0,0,2,1 (1ct 0st),0.4,
29,Mohibullah Oryakhel (AFG),2013-2013,2,2,2,2,0,0,2,1 (1ct 0st),1.0,
30,GMC Mol (NED),2007-2008,6,6,2,2,0,0,2,2 (2ct 0st),0.333,
31,HJC Mol (NED),2002-2008,10,10,2,2,0,0,2,1 (1ct 0st),0.2,
32,PJK Mooney (IRE),2006-2007,4,4,2,2,0,0,2,2 (2ct 0st),0.5,
33,JE Morris (ENG),1990-1991,8,8,2,2,0,0,2,1 (1ct 0st),0.25,
34,Morshed Ali Khan (BAN),1998-1998,3,3,2,2,0,0,2,1 (1ct 0st),0.666,
35,JK Moss (AUS),1979-1979,1,1,2,2,0,0,2,2 (2ct 0st),2.0,
36,EMDY Munaweera (SL),2017-2017,2,2,2,2,0,0,2,1 (1ct 0st),1.0,
37,W Mwayenga (ZIM),2002-2004,3,3,2,2,0,0,2,1 (1ct 0st),0.666,
38,D Myers (ZIM),2021-2021,4,4,2,2,0,0,2,1 (1ct 0st),0.5,
39,Nafees Iqbal (BAN),2003-2005,16,16,2,2,0,0,2,1 (1ct 0st),0.125,
40,PG Nana (EAf),1975-1975,3,3,2,2,0,0,2,1 (1ct 0st),0.666,
41,Nasir Ahmed (BAN),1988-1990,7,7,2,1,1,1,0,1 (1ct 0st),0.285,
42,Naved Latif (PAK),2001-2003,11,11,2,2,0,0,2,1 (1ct 0st),0.181,
43,Naveen-ul-Haq (AFG),2016-2021,7,7,2,2,0,0,2,1 (1ct 0st),0.285,
44,Najmul Hossain Shanto (BAN),2018-2021,8,8,2,2,0,0,2,2 (2ct 0st),0.25,
45,Nazmul Islam (BAN),2018-2018,5,5,2,2,0,0,2,1 (1ct 0st),0.4,
46,TS Nethula (NZ),2012-2012,5,5,2,2,0,0,2,1 (1ct 0st),0.4,
47,R Ngarava (ZIM),2017-2022,19,19,2,2,0,0,2,1 (1ct 0st),0.105,
48,A Nortje (SA),2019-2021,12,12,2,2,0,0,2,2 (2ct 0st),0.166,
49,FN Otieno (KENYA),2010-2010,4,4,2,2,0,0,2,1 (1ct 0st),0.5,
0,JV Paranjpe (INDIA),1998-1998,4,4,2,2,0,0,2,1 (1ct 0st),0.5,
1,TK Patel (USA),2019-2020,7,7,2,2,0,0,2,1 (1ct 0st),0.285,
2,D Paterson (SA),2017-2019,4,4,2,2,0,0,2,2 (2ct 0st),0.5,
3,GA Paterson (ZIM),1983-1987,10,10,2,2,0,0,2,1 (1ct 0st),0.2,
4,MDK Perera (SL),2007-2018,12,12,2,2,0,0,2,1 (1ct 0st),0.166,
5,PDRL Perera (SL),1999-2007,19,19,2,2,0,0,2,1 (1ct 0st),0.105,
6,Pervez Mir (PAK),1975-1977,3,3,2,2,0,0,2,1 (1ct 0st),0.666,
7,RG Petrie (NZ),1990-1991,12,12,2,2,0,0,2,1 (1ct 0st),0.166,
8,OL Pitcher (BMUDA),2007-2007,5,5,2,2,0,0,2,1 (1ct 0st),0.4,
9,MW Priest (NZ),1990-1998,16,16,2,2,0,0,2,1 (1ct 0st),0.125,
10,MW Pringle (SA),1992-1994,17,17,2,2,0,0,2,1 (1ct 0st),0.117,
11,PM Pushpakumara (SL),2017-2017,2,2,2,2,0,0,2,1 (1ct 0st),1.0,
12,NV Radford (ENG),1988-1988,6,6,2,2,0,0,2,2 (2ct 0st),0.333,
13,Raees Ahmadzai (AFG),2009-2010,5,5,2,2,0,0,2,1 (1ct 0st),0.4,
14,LS Rajput (INDIA),1985-1987,4,4,2,2,0,0,2,1 (1ct 0st),0.5,
15,WV Raman (INDIA),1988-1996,27,27,2,2,0,0,2,1 (1ct 0st),0.074,
16,S Ranatunga (SL),1994-1996,12,12,2,2,0,0,2,1 (1ct 0st),0.166,
17,D Ravu (PNG),2017-2021,15,15,2,2,0,0,2,1 (1ct 0st),0.133,
18,B Reddy (INDIA),1978-1981,3,3,2,2,0,2,0,1 (1ct 0st),0.666,
19,IR Redpath (AUS),1971-1975,5,5,2,2,0,0,2,1 (1ct 0st),0.4,
20,Rizwan-uz-Zaman (PAK),1981-1987,3,3,2,2,0,0,2,2 (2ct 0st),0.666,
21,GK Robertson (NZ),1981-1989,10,10,2,2,0,0,2,1 (1ct 0st),0.2,
22,NA Rock (IRE),2022-2022,3,3,2,2,0,2,0,2 (2ct 0st),0.666,
23,GA Rogers (SCOT),2006-2008,12,12,2,2,0,0,2,1 (1ct 0st),0.166,
24,GRJ Roope (ENG),1973-1978,7,7,2,2,0,0,2,1 (1ct 0st),0.285,
25,LG Rowe (WI),1975-1980,11,11,2,2,0,0,2,1 (1ct 0st),0.181,
26,Rumman Raees (PAK),2017-2018,9,9,2,2,0,0,2,1 (1ct 0st),0.222,
27,HD Rutherford (NZ),2013-2013,4,4,2,2,0,0,2,1 (1ct 0st),0.5,
28,Saeed Azad (PAK),1995-1996,4,4,2,2,0,0,2,1 (1ct 0st),0.5,
29,AK Sah (NEPAL),2018-2018,2,2,2,2,0,2,0,2 (2ct 0st),1.0,
30,C Sakariya (INDIA),2021-2021,1,1,2,2,0,0,2,2 (2ct 0st),2.0,
31,AM Salvi (INDIA),2003-2003,4,4,2,2,0,0,2,1 (1ct 0st),0.5,
32,Sameer Zia (UAE),2004-2004,1,1,2,2,0,0,2,2 (2ct 0st),2.0,
33,Saqib Ali (UAE),2008-2014,5,5,2,2,0,0,2,1 (1ct 0st),0.4,
34,Saqlain Haider (UAE),2014-2016,5,5,2,1,1,1,0,1 (1ct 0st),0.4,
35,Sarandeep Singh (INDIA),2002-2003,5,5,2,2,0,0,2,1 (1ct 0st),0.4,
36,AF Sattaur (CAN),2003-2003,3,3,2,2,0,0,2,2 (2ct 0st),0.666,
37,BM Scholtz (NAM),2019-2021,10,10,2,2,0,0,2,2 (2ct 0st),0.2,
38,S Seeraj (CAN),2006-2006,1,1,2,2,0,2,0,2 (2ct 0st),2.0,
39,KF Semple (WI),1999-1999,7,7,2,2,0,0,2,1 (1ct 0st),0.285,
40,CP Senanayake (SL),1990-1991,7,7,2,2,0,0,2,1 (1ct 0st),0.285,
41,Shahid Saeed (PAK),1989-1993,10,10,2,2,0,0,2,1 (1ct 0st),0.2,
42,Shahid Wasif (HKG),2016-2018,9,9,2,2,0,0,2,1 (1ct 0st),0.222,
43,G Sharma (INDIA),1985-1987,9,9,2,2,0,0,2,1 (1ct 0st),0.222,
44,PP Shaw (INDIA),2020-2021,6,6,2,2,0,0,2,1 (1ct 0st),0.333,
45,TG Shaw (SA),1991-1994,9,9,2,2,0,0,2,1 (1ct 0st),0.222,
46,MQ Sheikh (SCOT),2008-2010,6,6,2,2,0,0,2,1 (1ct 0st),0.333,
47,IT Shillingford (WI),1978-1978,2,2,2,2,0,0,2,1 (1ct 0st),1.0,
48,DJM Short (AUS),2018-2020,8,8,2,2,0,0,2,1 (1ct 0st),0.25,
49,ED Solkar (INDIA),1974-1976,7,7,2,2,0,0,2,1 (1ct 0st),0.285,
0,Sompal Kami (NEPAL),2018-2021,12,12,2,2,0,0,2,1 (1ct 0st),0.166,
1,IM Stanger (SCOT),1999-2006,5,5,2,2,0,0,2,1 (1ct 0st),0.4,
2,CAH Stevenson (USA),2019-2020,7,7,2,2,0,0,2,1 (1ct 0st),0.285,
3,GB Stevenson (ENG),1980-1981,4,4,2,2,0,0,2,1 (1ct 0st),0.5,
4,AM Stuart (AUS),1997-1997,3,3,2,2,0,0,2,2 (2ct 0st),0.666,
5,Taslim Arif (PAK),1980-1980,2,2,2,1,1,0,1,1 (1ct 0st),1.0,
6,SP Terry (IRE),2016-2016,5,5,2,2,0,0,2,2 (2ct 0st),0.4,
7,LO Tikolo (KENYA),1996-1996,3,3,2,2,0,0,2,1 (1ct 0st),0.666,
8,SS Tiwary (INDIA),2010-2010,3,3,2,2,0,0,2,1 (1ct 0st),0.666,
9,GB Troup (NZ),1976-1985,22,22,2,2,0,0,2,1 (1ct 0st),0.09,
10,TE Tucker (BMUDA),2008-2009,5,5,2,2,0,0,2,1 (1ct 0st),0.4,
11,KEA Upashantha (SL),1995-2001,12,12,2,2,0,0,2,1 (1ct 0st),0.166,
12,PS Vaidya (INDIA),1995-1996,4,4,2,2,0,0,2,1 (1ct 0st),0.5,
13,RF van Oosterom (NED),1996-2002,3,3,2,2,0,0,2,1 (1ct 0st),0.666,
14,C Viljoen (NAM),2019-2019,2,2,2,2,0,0,2,2 (2ct 0st),1.0,
15,TP Visee (NED),2019-2021,3,3,2,2,0,0,2,1 (1ct 0st),0.666,
16,KDK Vithanage (SL),2013-2014,6,6,2,2,0,0,2,1 (1ct 0st),0.333,
17,MDJ Walker (NZ),2003-2003,3,3,2,2,0,0,2,1 (1ct 0st),0.666,
18,HR Walsh (USA/WI),2019-2021,13,13,2,2,0,0,2,1 (1ct 0st),0.153,
19,KPJ Warnaweera (SL),1990-1993,6,6,2,2,0,0,2,1 (1ct 0st),0.333,
20,AS Wassan (INDIA),1990-1991,9,9,2,2,0,0,2,1 (1ct 0st),0.222,
21,DS Weerakkody (SL),2017-2017,3,3,2,2,0,0,2,1 (1ct 0st),0.666,
22,UWMBCA Welegedara (SL),2009-2010,9,9,2,2,0,0,2,1 (1ct 0st),0.222,
23,JM Wiener (AUS),1979-1980,7,7,2,2,0,0,2,1 (1ct 0st),0.285,
24,HS Williams (SA),1999-2000,7,7,2,2,0,0,2,2 (2ct 0st),0.285,
25,PJ Wiseman (NZ),1998-2003,13,13,2,2,0,0,2,1 (1ct 0st),0.153,
26,RD Woolley (AUS),1983-1983,2,2,2,1,1,1,0,2 (1ct 1st),1.0,
27,GH Worker (NZ),2015-2018,9,9,2,2,0,0,2,2 (2ct 0st),0.222,
28,Yasir Arafat (PAK),2000-2009,11,11,2,2,0,0,2,1 (1ct 0st),0.181,
29,B Yograj Singh (INDIA),1980-1981,6,6,2,2,0,0,2,1 (1ct 0st),0.333,
30,BE Young (AUS),1998-1999,6,6,2,2,0,0,2,1 (1ct 0st),0.333,
31,Zahid Fazal (PAK),1990-1994,19,19,2,2,0,0,2,1 (1ct 0st),0.105,
32,Zahoor Elahi (PAK),1996-1997,14,14,2,2,0,0,2,1 (1ct 0st),0.142,
33,Zulqarnain Haider (PAK),2010-2010,4,4,2,1,1,1,0,2 (1ct 1st),0.5,
34,Aamer Hameed (PAK),1977-1978,2,2,1,1,0,0,1,1 (1ct 0st),0.5,
35,VR Aaron (INDIA),2011-2014,9,9,1,1,0,0,1,1 (1ct 0st),0.111,
36,JS Ababu (KENYA),1999-2006,9,9,1,1,0,0,1,1 (1ct 0st),0.111,
37,Abdullah Mazari (AFG),2010-2010,2,2,1,1,0,0,1,1 (1ct 0st),0.5,
38,Abdul Jabbar (CAN),2007-2007,2,2,1,1,0,0,1,1 (1ct 0st),0.5,
39,S Abrahams (SA),2000-2000,1,1,1,1,0,0,1,1 (1ct 0st),1.0,
40,Abul Hasan (BAN),2012-2018,7,7,1,1,0,0,1,1 (1ct 0st),0.142,
41,Abu Hider (BAN),2018-2018,2,2,1,1,0,0,1,1 (1ct 0st),0.5,
42,CN Ackermann (NED),2022-2022,3,3,1,1,0,0,1,1 (1ct 0st),0.333,
43,Afzaal Haider (HKG),2004-2008,4,4,1,1,0,0,1,1 (1ct 0st),0.25,
44,JP Agnew (ENG),1985-1985,3,3,1,1,0,0,1,1 (1ct 0st),0.333,
45,KK Ahmed (INDIA),2018-2019,10,10,1,1,0,0,1,1 (1ct 0st),0.1,
46,Aijaz Ali (USA),2004-2004,2,2,1,1,0,0,1,1 (1ct 0st),0.5,
47,RW Ali (KENYA),1996-1997,8,8,1,1,0,0,1,1 (1ct 0st),0.125,
48,DI Allan (KENYA),2011-2013,5,5,1,1,0,0,1,1 (1ct 0st),0.2,
49,MJD Allingham (SCOT),1999-1999,3,3,1,1,0,0,1,1 (1ct 0st),0.333,
0,Al-Amin Hossain (BAN),2014-2020,14,14,1,1,0,0,1,1 (1ct 0st),0.071,
1,S Amarnath (INDIA),1978-1978,3,3,1,1,0,0,1,1 (1ct 0st),0.333,
2,MKDI Amerasinghe (SL),2007-2008,7,7,1,1,0,0,1,1 (1ct 0st),0.142,
3,CR Amini (PNG),2014-2014,2,2,1,1,0,0,1,1 (1ct 0st),0.5,
4,RW Anderson (NZ),1976-1978,2,2,1,1,0,0,1,1 (1ct 0st),0.5,
5,Ankur Vasishta (HKG),2014-2014,4,4,1,1,0,0,1,1 (1ct 0st),0.25,
6,Arshad Ali (UAE),2004-2008,4,4,1,1,0,0,1,1 (1ct 0st),0.25,
7,Arshad Laeeq (UAE),1994-1996,6,6,1,1,0,0,1,1 (1ct 0st),0.166,
8,KIC Asalanka (SL),2021-2022,11,11,1,1,0,0,1,1 (1ct 0st),0.09,
9,Asif Masood (PAK),1973-1976,7,7,1,1,0,0,1,1 (1ct 0st),0.142,
10,Azmatullah Omarzai (AFG),2021-2022,2,2,1,1,0,0,1,1 (1ct 0st),0.5,
11,RJ Bailey (ENG),1985-1990,4,4,1,1,0,0,1,1 (1ct 0st),0.25,
12,Basil Hameed (UAE),2019-2021,7,7,1,1,0,0,1,1 (1ct 0st),0.142,
13,TC Bastiampillai (CAN),2007-2014,13,13,1,1,0,0,1,1 (1ct 0st),0.076,
14,MD Bates (NZ),2012-2012,2,2,1,1,0,0,1,1 (1ct 0st),0.5,
15,Bazid Khan (PAK),2004-2008,5,5,1,1,0,0,1,1 (1ct 0st),0.2,
16,MD Bell (NZ),1998-2001,7,7,1,1,0,0,1,1 (1ct 0st),0.142,
17,MJ Bennett (AUS),1984-1985,8,8,1,1,0,0,1,1 (1ct 0st),0.125,
18,Bilal Khan (OMA),2019-2021,19,19,1,1,0,0,1,1 (1ct 0st),0.052,
19,GA Bishop (AUS),1987-1987,2,2,1,1,0,0,1,1 (1ct 0st),0.5,
20,J Blackwood (WI),2015-2015,2,2,1,1,0,0,1,1 (1ct 0st),0.5,
21,TA Blundell (NZ),2020-2020,2,2,1,1,0,0,1,1 (1ct 0st),0.5,
22,GH Bodi (SA),2007-2007,2,2,1,1,0,0,1,1 (1ct 0st),0.5,
23,PRP Boissevain (NED),2021-2022,4,4,1,1,0,0,1,1 (1ct 0st),0.25,
24,JWHD Boteju (SL),1999-1999,2,2,1,1,0,0,1,1 (1ct 0st),0.5,
25,JE Brinkley (SCOT),1999-1999,5,5,1,1,0,0,1,1 (1ct 0st),0.2,
26,SSJ Brooks (WI),2022-2022,3,3,1,1,0,0,1,1 (1ct 0st),0.333,
27,RE Bryson (SA),1997-1997,7,7,1,1,0,0,1,1 (1ct 0st),0.142,
28,SF Burger (NAM),2003-2003,2,2,1,1,0,0,1,1 (1ct 0st),0.5,
29,SJ Cameron (SCOT),2018-2018,2,2,1,1,0,0,1,1 (1ct 0st),0.5,
30,TK Canning (NZ),2003-2005,4,4,1,1,0,0,1,1 (1ct 0st),0.25,
31,HWR Cartwright (AUS),2017-2017,2,2,1,1,0,0,1,1 (1ct 0st),0.5,
32,DL Chahar (INDIA),2018-2022,6,6,1,1,0,0,1,1 (1ct 0st),0.166,
33,MS Chapman (HKG/NZ),2015-2020,6,6,1,1,0,0,1,1 (1ct 0st),0.166,
34,U Chatterjee (INDIA),1995-1995,3,3,1,1,0,0,1,1 (1ct 0st),0.333,
35,DB Close (ENG),1972-1972,3,3,1,1,0,0,1,1 (1ct 0st),0.333,
36,RO Collinge (NZ),1973-1978,12,12,1,1,0,0,1,1 (1ct 0st),0.083,
37,PC Connell (IRE),2008-2010,12,12,1,1,0,0,1,1 (1ct 0st),0.083,
38,SJ Cook (SA),1991-1993,4,4,1,1,0,0,1,1 (1ct 0st),0.25,
39,GJ Crocker (ZIM),1992-1993,6,6,1,1,0,0,1,1 (1ct 0st),0.166,
40,CEH Croft (WI),1977-1981,19,19,1,1,0,0,1,1 (1ct 0st),0.052,
41,ML Cummins (WI),2014-2017,8,8,1,1,0,0,1,1 (1ct 0st),0.125,
42,KM Curran (ZIM),1983-1987,11,11,1,1,0,0,1,1 (1ct 0st),0.09,
43,BCJ Cutting (AUS),2013-2014,4,4,1,1,0,0,1,1 (1ct 0st),0.25,
44,DDP D'Silva (UAE),2019-2020,6,6,1,1,0,0,1,1 (1ct 0st),0.166,
45,CJ Dala (SA),2018-2018,2,2,1,1,0,0,1,1 (1ct 0st),0.5,
46,WW Davis (WI),1983-1988,34,34,1,1,0,0,1,1 (1ct 0st),0.029,
47,AC Dawson (SA),1998-2004,18,18,1,1,0,0,1,1 (1ct 0st),0.055,
48,MH Denness (ENG),1973-1975,11,11,1,1,0,0,1,1 (1ct 0st),0.09,
49,JH Desai (USA),2004-2004,1,1,1,1,0,0,1,1 (1ct 0st),1.0,
0,DLS de Silva (SL),1979-1979,2,2,1,1,0,0,1,1 (1ct 0st),0.5,
1,R Dhanraj (WI),1994-1995,5,5,1,1,0,0,1,1 (1ct 0st),0.2,
2,AB Dinda (INDIA),2010-2013,13,13,1,1,0,0,1,1 (1ct 0st),0.076,
3,MJ Di Venuto (AUS),1997-1997,9,9,1,1,0,0,1,1 (1ct 0st),0.111,
4,BL D'Oliveira (ENG),1971-1972,4,4,1,1,0,0,1,1 (1ct 0st),0.25,
5,G Dymock (AUS),1974-1980,14,14,1,1,0,0,1,1 (1ct 0st),0.071,
6,RR Emrit (WI),2007-2007,2,2,1,1,0,0,1,1 (1ct 0st),0.5,
7,Fahad Usman (UAE),2004-2004,2,2,1,1,0,0,1,1 (1ct 0st),0.5,
8,Fazle Mahmud (BAN),2018-2018,2,2,1,1,0,0,1,1 (1ct 0st),0.5,
9,B Fernando (SL),2021-2021,3,3,1,1,0,0,1,1 (1ct 0st),0.333,
10,BOP Fernando (SL),2019-2021,7,7,1,1,0,0,1,1 (1ct 0st),0.142,
11,KADM Fernando (SL),2003-2003,1,1,1,1,0,0,1,1 (1ct 0st),1.0,
12,J Figy (UAE),2019-2020,2,2,1,1,0,0,1,1 (1ct 0st),0.5,
13,MV Fleming (ENG),1997-1998,11,11,1,1,0,0,1,1 (1ct 0st),0.09,
14,MJ Fourie (IRE),2007-2008,6,6,1,1,0,0,1,1 (1ct 0st),0.166,
15,PJ Franks (ENG),2000-2000,1,1,1,1,0,0,1,1 (1ct 0st),1.0,
16,RS Gabriel (WI),1984-1984,11,11,1,1,0,0,1,1 (1ct 0st),0.09,
17,ST Gabriel (WI),2016-2019,25,25,1,1,0,0,1,1 (1ct 0st),0.04,
18,WCA Ganegama (SL),2001-2006,4,4,1,1,0,0,1,1 (1ct 0st),0.25,
19,TN Garwe (ZIM),2009-2009,1,1,1,1,0,0,1,1 (1ct 0st),1.0,
20,SP Gauchan (NEPAL),2018-2018,1,1,1,1,0,0,1,1 (1ct 0st),1.0,
21,Gazi Ashraf (BAN),1986-1990,7,7,1,1,0,0,1,1 (1ct 0st),0.142,
22,B Geeves (AUS),2008-2009,2,2,1,1,0,0,1,1 (1ct 0st),0.5,
23,SC Getkate (IRE),2019-2021,4,4,1,1,0,0,1,1 (1ct 0st),0.25,
24,N Gifford (ENG),1985-1985,2,2,1,1,0,0,1,1 (1ct 0st),0.5,
25,K Gowtham (INDIA),2021-2021,1,1,1,1,0,0,1,1 (1ct 0st),1.0,
26,SF Graf (AUS),1980-1981,10,10,1,1,0,0,1,1 (1ct 0st),0.1,
27,AP Grayson (ENG),2000-2001,2,2,1,1,0,0,1,1 (1ct 0st),0.5,
28,Gurkeerat Singh (INDIA),2016-2016,3,3,1,1,0,0,1,1 (1ct 0st),0.333,
29,HF Gurney (ENG),2014-2014,10,10,1,1,0,0,1,1 (1ct 0st),0.1,
30,Gursharan Singh (INDIA),1990-1990,1,1,1,1,0,0,1,1 (1ct 0st),1.0,
31,AM Guruge (UAE),2014-2015,7,7,1,1,0,0,1,1 (1ct 0st),0.142,
32,Haider Ali (PAK),2020-2020,2,2,1,1,0,0,1,1 (1ct 0st),0.5,
33,RS Haire (IRE),2008-2008,2,2,1,1,0,0,1,1 (1ct 0st),0.5,
34,JV Harris (CAN),2003-2003,6,6,1,1,0,0,1,1 (1ct 0st),0.166,
35,RG Hart (NZ),2002-2002,2,2,1,1,0,1,0,1 (1ct 0st),0.5,
36,Hasan Jamil (PAK),1977-1978,6,6,1,1,0,0,1,1 (1ct 0st),0.166,
37,Hasan Raza (PAK),1996-1999,15,15,1,1,0,0,1,1 (1ct 0st),0.066,
38,TJ Heggelman (NED),2010-2011,5,5,1,1,0,0,1,1 (1ct 0st),0.2,
39,O Henry (SA),1992-1992,3,3,1,1,0,0,1,1 (1ct 0st),0.333,
40,JG Heron (ZIM),1983-1983,6,6,1,1,0,0,1,1 (1ct 0st),0.166,
41,PD Heyn (SL),1975-1975,2,2,1,1,0,0,1,1 (1ct 0st),0.5,
42,AMJ Hilditch (AUS),1979-1985,8,8,1,1,0,0,1,1 (1ct 0st),0.125,
43,RO Hinds (WI),2001-2004,13,13,1,1,0,0,1,1 (1ct 0st),0.076,
44,KC Hodsoll (BMUDA),2007-2008,3,3,1,1,0,0,1,1 (1ct 0st),0.333,
45,CK Hooper (CAN),2007-2010,5,5,1,1,0,0,1,1 (1ct 0st),0.2,
46,KA Hope (WI),2017-2017,6,6,1,1,0,0,1,1 (1ct 0st),0.166,
47,AG Hurst (AUS),1975-1979,7,7,1,1,0,0,1,1 (1ct 0st),0.142,
48,RO Hussain (SCOT),2006-2010,7,7,1,1,0,0,1,1 (1ct 0st),0.142,
49,KH Butt (HKG),2008-2008,2,2,1,1,0,0,1,1 (1ct 0st),0.5,
0,DP Hyatt (WI),2011-2011,9,9,1,1,0,0,1,1 (1ct 0st),0.111,
1,Ibrahim Zadran (AFG),2019-2019,1,1,1,1,0,0,1,1 (1ct 0st),1.0,
2,AP Igglesden (ENG),1994-1994,4,4,1,1,0,0,1,1 (1ct 0st),0.25,
3,Ijaz Ahmed jnr (PAK),1997-1997,2,2,1,1,0,0,1,1 (1ct 0st),0.5,
4,R Illingworth (ENG),1971-1973,2,2,1,1,0,0,1,1 (1ct 0st),0.5,
5,Imran Abbas (PAK),2000-2000,2,2,1,1,0,0,1,1 (1ct 0st),0.5,
6,MM Iqbal (SCOT),2009-2014,13,13,1,1,0,0,1,1 (1ct 0st),0.076,
7,Irfan Bhatti (PAK),1993-1993,1,1,1,1,0,0,1,1 (1ct 0st),1.0,
8,Izatullah Dawlatzai (AFG),2010-2015,5,5,1,1,0,0,1,1 (1ct 0st),0.2,
9,Jahangir Alam (BAN),1997-1999,3,3,1,0,1,0,0,1 (0ct 1st),0.333,
10,Jahangir Shah (BAN),1986-1990,5,5,1,1,0,0,1,1 (1ct 0st),0.2,
11,Jalal-ud-Din (PAK),1982-1983,7,7,1,1,0,0,1,1 (1ct 0st),0.142,
12,Jamaluddin Ahmed (BAN),2003-2003,1,1,1,1,0,0,1,1 (1ct 0st),1.0,
13,F Jansen (NED),1996-1996,2,2,1,1,0,0,1,1 (1ct 0st),0.5,
14,MP Jarvis (ZIM),1987-1995,12,12,1,1,0,0,1,1 (1ct 0st),0.083,
15,PW Jarvis (ENG),1988-1993,16,16,1,1,0,0,1,1 (1ct 0st),0.062,
16,Javed Qadeer (PAK),1995-1995,1,1,1,1,0,1,0,1 (1ct 0st),1.0,
17,SA Jayasinghe (SL),1979-1979,2,2,1,1,0,1,0,1 (1ct 0st),0.5,
18,GSNFG Jayasuriya (SL),2015-2019,12,12,1,1,0,0,1,1 (1ct 0st),0.083,
19,Jay Odedra (OMA),2019-2020,3,3,1,1,0,0,1,1 (1ct 0st),0.333,
20,S Jeganathan (SL),1983-1988,5,5,1,1,0,0,1,1 (1ct 0st),0.2,
21,MR Johnson (USA),2004-2004,2,2,1,1,0,1,0,1 (1ct 0st),0.5,
22,MBS Jonkman (NED),2006-2010,16,16,1,1,0,0,1,1 (1ct 0st),0.062,
23,MMA Jonkman (NED),2007-2010,4,4,1,1,0,0,1,1 (1ct 0st),0.25,
24,DI Joyce (IRE),2006-2007,3,3,1,1,0,0,1,1 (1ct 0st),0.333,
25,Jubair Hossain (BAN),2014-2015,3,3,1,1,0,0,1,1 (1ct 0st),0.333,
26,Kabir Khan (PAK),1994-2000,9,9,1,1,0,0,1,1 (1ct 0st),0.111,
27,Kamran Shazad (UAE),2014-2015,4,4,1,1,0,0,1,1 (1ct 0st),0.25,
28,TS Kamunhukamwe (ZIM),2018-2021,7,7,1,1,0,0,1,1 (1ct 0st),0.142,
29,AR Kapoor (INDIA),1995-2000,17,17,1,1,0,0,1,1 (1ct 0st),0.058,
30,Karan KC (NEPAL),2018-2021,14,14,1,1,0,0,1,1 (1ct 0st),0.071,
31,M Karg (NAM),2003-2003,3,3,1,1,0,1,0,1 (1ct 0st),0.333,
32,SHU Karnain (SL),1984-1990,19,19,1,1,0,0,1,1 (1ct 0st),0.052,
33,S Kaul (INDIA),2018-2018,3,3,1,1,0,0,1,1 (1ct 0st),0.333,
34,RJ Kennedy (NZ),1996-1996,7,7,1,1,0,0,1,1 (1ct 0st),0.142,
35,JC Kent (SA),2002-2002,2,2,1,1,0,0,1,1 (1ct 0st),0.5,
36,RB Kerr (AUS),1985-1985,4,4,1,1,0,0,1,1 (1ct 0st),0.25,
37,S Keshvani (CAN),2009-2009,4,4,1,1,0,0,1,1 (1ct 0st),0.25,
38,SP Khakurel (NEPAL),2018-2020,5,5,1,0,1,0,0,1 (0ct 1st),0.2,
39,Khalid Latif (PAK),2008-2010,5,5,1,1,0,0,1,1 (1ct 0st),0.2,
40,Khurram Nawaz (OMA),2019-2019,3,3,1,1,0,0,1,1 (1ct 0st),0.333,
41,Khushdil Shah (PAK),2020-2020,1,1,1,1,0,0,1,1 (1ct 0st),1.0,
42,GE Kidd (IRE),2007-2008,5,5,1,1,0,0,1,1 (1ct 0st),0.2,
43,VJ Kingma (NED),2014-2022,9,9,1,1,0,0,1,1 (1ct 0st),0.111,
44,R Klein (NED),2022-2022,1,1,1,1,0,0,1,1 (1ct 0st),1.0,
45,JF Kloppenburg (NED),2002-2003,6,6,1,1,0,0,1,1 (1ct 0st),0.166,
46,BL Kotze (NAM),2003-2003,5,5,1,1,0,0,1,1 (1ct 0st),0.2,
47,GJP Kruger (SA),2006-2006,3,3,1,1,0,0,1,1 (1ct 0st),0.333,
48,CKB Kulasekara (SL),2011-2012,4,4,1,1,0,0,1,1 (1ct 0st),0.25,
49,NM Kulkarni (INDIA),1997-1998,8,8,1,1,0,0,1,1 (1ct 0st),0.125,
0,JPR Lamsam (HKG),2004-2008,2,2,1,1,0,0,1,1 (1ct 0st),0.5,
1,WM Lawry (AUS),1971-1971,1,1,1,1,0,0,1,1 (1ct 0st),1.0,
2,ML Lewis (AUS),2005-2006,7,7,1,1,0,0,1,1 (1ct 0st),0.142,
3,JB Little (IRE),2019-2022,17,17,1,1,0,0,1,1 (1ct 0st),0.058,
4,LS Livingstone (ENG),2021-2021,3,3,1,1,0,0,1,1 (1ct 0st),0.333,
5,ACI Lock (ZIM),1996-1996,7,7,1,1,0,0,1,1 (1ct 0st),0.142,
6,JL Louw (NAM),2003-2003,1,1,1,1,0,0,1,1 (1ct 0st),1.0,
7,JD Love (ENG),1981-1981,3,3,1,1,0,0,1,1 (1ct 0st),0.333,
8,SW Lubbers (NED),1996-1996,4,4,1,1,0,0,1,1 (1ct 0st),0.25,
9,MJ Lumb (ENG),2014-2014,3,3,1,1,0,0,1,1 (1ct 0st),0.333,
10,AS Luseno (KENYA),2003-2010,10,10,1,1,0,0,1,1 (1ct 0st),0.1,
11,MA Lynch (ENG),1988-1988,3,3,1,1,0,0,1,1 (1ct 0st),0.333,
12,RJ McCurdy (AUS),1985-1985,11,11,1,1,0,0,1,1 (1ct 0st),0.09,
13,PE McEwan (NZ),1980-1985,15,15,1,1,0,0,1,1 (1ct 0st),0.066,
14,AJ Mackay (ZIM),2001-2001,3,3,1,1,0,0,1,1 (1ct 0st),0.333,
15,GD McKenzie (AUS),1971-1971,1,1,1,1,0,0,1,1 (1ct 0st),1.0,
16,DL Maddy (ENG),1998-2000,8,8,1,1,0,0,1,1 (1ct 0st),0.125,
17,Mafizur Rahman (BAN),1997-1997,4,4,1,1,0,0,1,1 (1ct 0st),0.25,
18,KA Maharaj (SA),2017-2022,16,16,1,1,0,0,1,1 (1ct 0st),0.062,
19,Mahbubul Alam (BAN),2009-2009,5,5,1,1,0,0,1,1 (1ct 0st),0.2,
20,S Mahmood (ENG),2020-2021,7,7,1,1,0,0,1,1 (1ct 0st),0.142,
21,SI Mahmood (ENG),2004-2009,25,25,1,1,0,0,1,1 (1ct 0st),0.04,
22,DE Malcolm (ENG),1990-1994,10,10,1,1,0,0,1,1 (1ct 0st),0.1,
23,MF Malone (AUS),1977-1982,10,10,1,1,0,0,1,1 (1ct 0st),0.1,
24,Manzoor Akhtar (PAK),1997-1998,7,7,1,1,0,0,1,1 (1ct 0st),0.142,
25,PJ Martin (ENG),1995-1998,19,19,1,1,0,0,1,1 (1ct 0st),0.052,
26,T Marumani (ZIM),2021-2021,3,3,1,1,0,0,1,1 (1ct 0st),0.333,
27,RAL Massie (AUS),1972-1972,3,3,1,1,0,0,1,1 (1ct 0st),0.333,
28,EZ Matambanadzo (ZIM),1996-1997,7,7,1,1,0,0,1,1 (1ct 0st),0.142,
29,Mazhar Hussain (UAE),1994-1996,7,7,1,1,0,0,1,1 (1ct 0st),0.142,
30,V Mehra (UAE),1994-1996,6,6,1,1,0,0,1,1 (1ct 0st),0.166,
31,KP Meiyappan (UAE),2019-2021,6,6,1,1,0,0,1,1 (1ct 0st),0.166,
32,RTM Mendis (SL),2021-2022,4,4,1,1,0,0,1,1 (1ct 0st),0.25,
33,KO Meth (ZIM),2006-2012,10,10,1,1,0,0,1,1 (1ct 0st),0.1,
34,JP Millmow (NZ),1990-1990,5,5,1,1,0,0,1,1 (1ct 0st),0.2,
35,A Mithun (INDIA),2010-2011,5,5,1,1,0,0,1,1 (1ct 0st),0.2,
36,SJ Modani (USA),2021-2021,5,5,1,1,0,0,1,1 (1ct 0st),0.2,
37,Mohammad Boota (UAE),2018-2019,9,9,1,0,1,0,0,1 (0ct 1st),0.111,
38,Mohammad Ishaq (UAE),1994-1996,5,5,1,1,0,0,1,1 (1ct 0st),0.2,
39,Mohammad Salim (BAN),2003-2003,1,1,1,1,0,1,0,1 (1ct 0st),1.0,
40,Mohammad Sharif (BAN),2001-2007,9,9,1,1,0,0,1,1 (1ct 0st),0.111,
41,Mohammad Zahid (PAK),1996-2002,11,11,1,1,0,0,1,1 (1ct 0st),0.09,
42,D Mohammed (WI),2006-2008,6,6,1,1,0,0,1,1 (1ct 0st),0.166,
43,KV Morea (PNG),2021-2021,4,4,1,1,0,0,1,1 (1ct 0st),0.25,
44,Mosharraf Hossain (BAN),2008-2016,5,5,1,1,0,0,1,1 (1ct 0st),0.2,
45,TV Mufambisi (ZIM),2006-2007,6,6,1,1,0,1,0,1 (1ct 0st),0.166,
46,SP Mukherjee (INDIA),1990-1991,3,3,1,1,0,0,1,1 (1ct 0st),0.333,
47,J Mulder (IRE),2017-2017,4,4,1,1,0,0,1,1 (1ct 0st),0.25,
48,CT Mumba (ZIM),2016-2020,7,7,1,1,0,0,1,1 (1ct 0st),0.142,
49,Musa Ahmed (NED),2021-2022,3,3,1,1,0,0,1,1 (1ct 0st),0.333,
0,N M'shangwe (ZIM),2011-2014,6,6,1,1,0,0,1,1 (1ct 0st),0.166,
1,DT Mutendera (ZIM),1999-2001,9,9,1,1,0,0,1,1 (1ct 0st),0.111,
2,G Mylvaganam (UAE),1996-1996,3,3,1,1,0,0,1,1 (1ct 0st),0.333,
3,Naeemuddin Aslam (UAE),2004-2004,2,2,1,1,0,0,1,1 (1ct 0st),0.5,
4,Naeem Ahmed (PAK),1978-1978,1,1,1,1,0,0,1,1 (1ct 0st),1.0,
5,Najeeb Amar (HKG),2004-2008,4,4,1,1,0,0,1,1 (1ct 0st),0.25,
6,BP Nash (WI),2008-2009,7,7,1,1,0,0,1,1 (1ct 0st),0.142,
7,SV Nayak (INDIA),1981-1982,4,4,1,1,0,0,1,1 (1ct 0st),0.25,
8,Nazimuddin (BAN),2008-2012,11,11,1,1,0,0,1,1 (1ct 0st),0.09,
9,Neeyamur Rashid (BAN),1999-1999,2,2,1,1,0,0,1,1 (1ct 0st),0.5,
10,A Neill (SCOT),2019-2021,2,2,1,1,0,0,1,1 (1ct 0st),0.5,
11,Noor-ul-Haq (AFG),2010-2010,2,2,1,1,0,0,1,1 (1ct 0st),0.5,
12,MJ North (AUS),2009-2009,2,2,1,1,0,0,1,1 (1ct 0st),0.5,
13,GH O'Brien (BMUDA),2006-2008,9,9,1,1,0,0,1,1 (1ct 0st),0.111,
14,IE O'Brien (NZ),2008-2009,8,8,1,1,0,0,1,1 (1ct 0st),0.125,
15,NM Odhiambo (KENYA),2010-2013,8,8,1,1,0,0,1,1 (1ct 0st),0.125,
16,NV Ojha (INDIA),2010-2010,1,1,1,0,1,0,0,1 (0ct 1st),1.0,
17,LN Oluoch (KENYA),2011-2011,2,2,1,1,0,0,1,1 (1ct 0st),0.5,
18,G Onions (ENG),2009-2009,4,4,1,1,0,0,1,1 (1ct 0st),0.25,
19,KY Ottley (WI),2021-2021,2,2,1,1,0,0,1,1 (1ct 0st),0.5,
20,KH Pandya (INDIA),2021-2021,5,5,1,1,0,0,1,1 (1ct 0st),0.2,
21,Pankaj Singh (INDIA),2010-2010,1,1,1,1,0,0,1,1 (1ct 0st),1.0,
22,MHW Papps (NZ),2004-2005,6,6,1,1,0,0,1,1 (1ct 0st),0.166,
23,JS Paris (AUS),2016-2016,2,2,1,1,0,0,1,1 (1ct 0st),0.5,
24,NM Parker (NZ),1976-1976,1,1,1,1,0,0,1,1 (1ct 0st),1.0,
25,MW Parkinson (ENG),2020-2021,4,4,1,1,0,0,1,1 (1ct 0st),0.25,
26,AK Patel (INDIA),1984-1985,6,6,1,1,0,0,1,1 (1ct 0st),0.166,
27,BP Patel (INDIA),1974-1979,10,10,1,1,0,0,1,1 (1ct 0st),0.1,
28,J Patraj (CAN),2007-2007,2,2,1,1,0,0,1,1 (1ct 0st),0.5,
29,SG Peall (ZIM),1992-1996,19,19,1,1,0,0,1,1 (1ct 0st),0.052,
30,AJ Penn (NZ),1997-2001,5,5,1,1,0,0,1,1 (1ct 0st),0.2,
31,AK Perera (SL),2013-2019,6,6,1,1,0,0,1,1 (1ct 0st),0.166,
32,PARP Perera (SL),2019-2019,2,2,1,1,0,0,1,1 (1ct 0st),0.5,
33,V Permaul (WI),2012-2017,7,7,1,1,0,0,1,1 (1ct 0st),0.142,
34,JR Philippe (AUS),2021-2021,3,3,1,1,0,0,1,1 (1ct 0st),0.333,
35,K Phillip (USA),2021-2021,2,2,1,1,0,0,1,1 (1ct 0st),0.5,
36,AR Pitcher (BMUDA),2006-2007,4,4,1,1,0,0,1,1 (1ct 0st),0.25,
37,V Pollard (NZ),1973-1974,2,2,1,1,0,0,1,1 (1ct 0st),0.5,
38,RH Poonawala (UAE),1994-1994,2,2,1,1,0,0,1,1 (1ct 0st),0.5,
39,GD Porter (AUS),1979-1979,2,2,1,1,0,0,1,1 (1ct 0st),0.5,
40,KTGD Prasad (SL),2006-2015,22,22,1,1,0,0,1,1 (1ct 0st),0.045,
41,AG Puttick (SA),2005-2005,1,1,1,1,0,0,1,1 (1ct 0st),1.0,
42,Qadeer Ahmed (UAE),2015-2019,11,11,1,1,0,0,1,1 (1ct 0st),0.09,
43,Rahat Ali (PAK),2012-2016,14,14,1,1,0,0,1,1 (1ct 0st),0.071,
44,P Raho (PNG),2014-2014,1,1,1,1,0,0,1,1 (1ct 0st),1.0,
45,LN Rajbanshi (NEPAL),2019-2020,4,4,1,1,0,0,1,1 (1ct 0st),0.25,
46,CAK Rajitha (SL),2018-2021,10,10,1,1,0,0,1,1 (1ct 0st),0.1,
47,D Ranatunga (SL),1990-1990,4,4,1,1,0,0,1,1 (1ct 0st),0.25,
48,U Ranchod (ZIM),1992-1993,3,3,1,1,0,0,1,1 (1ct 0st),0.333,
49,Raqibul Hasan (BAN),1986-1986,2,2,1,1,0,0,1,1 (1ct 0st),0.5,
0,JB Reva (PNG),2016-2018,9,9,1,1,0,0,1,1 (1ct 0st),0.111,
1,ACL Richards (WI),2007-2007,1,1,1,1,0,0,1,1 (1ct 0st),1.0,
2,MH Richardson (NZ),2002-2002,4,4,1,1,0,0,1,1 (1ct 0st),0.25,
3,DOD Rikhi (USA),2021-2021,2,2,1,1,0,0,1,1 (1ct 0st),0.5,
4,Rizwan Ahmed (PAK),2008-2008,1,1,1,1,0,0,1,1 (1ct 0st),1.0,
5,ADG Roberts (NZ),1976-1976,1,1,1,1,0,0,1,1 (1ct 0st),1.0,
6,RJ Robinson (BMUDA),2007-2009,3,3,1,1,0,0,1,1 (1ct 0st),0.333,
7,LN Roche (ZIM),2018-2018,3,3,1,1,0,0,1,1 (1ct 0st),0.333,
8,Rokhan Barakzai (AFG),2015-2015,1,1,1,1,0,0,1,1 (1ct 0st),1.0,
9,LC Romero (USA),2004-2004,2,2,1,1,0,0,1,1 (1ct 0st),0.5,
10,BC Rose (ENG),1977-1977,2,2,1,1,0,0,1,1 (1ct 0st),0.5,
11,MW Rushmere (SA),1992-1992,4,4,1,1,0,0,1,1 (1ct 0st),0.25,
12,Saadat Ali (PAK),1984-1984,7,7,1,1,0,0,1,1 (1ct 0st),0.142,
13,Saeed-al-Saffar (UAE),1996-1996,1,1,1,1,0,0,1,1 (1ct 0st),1.0,
14,Sajid Ali (PAK),1984-1997,12,12,1,1,0,0,1,1 (1ct 0st),0.083,
15,Saleem Altaf (PAK),1973-1978,6,6,1,1,0,0,1,1 (1ct 0st),0.166,
16,IDK Salisbury (ENG),1993-1994,4,4,1,1,0,0,1,1 (1ct 0st),0.25,
17,G Salmond (SCOT),1999-1999,5,5,1,1,0,0,1,1 (1ct 0st),0.2,
18,JA Samarasekera (UAE),1994-1996,7,7,1,1,0,0,1,1 (1ct 0st),0.142,
19,S Samarawickrama (SL),2017-2019,7,7,1,1,0,0,1,1 (1ct 0st),0.142,
20,Samiur Rahman (BAN),1986-1986,2,2,1,1,0,0,1,1 (1ct 0st),0.5,
21,SV Samson (INDIA),2021-2021,1,1,1,0,1,0,0,1 (0ct 1st),1.0,
22,RG Samuels (WI),1996-1997,8,8,1,1,0,0,1,1 (1ct 0st),0.125,
23,KT Sandher (CAN),2006-2007,15,15,1,1,0,0,1,1 (1ct 0st),0.066,
24,BB Seebaran (CAN),2003-2003,4,4,1,1,0,0,1,1 (1ct 0st),0.25,
25,CS Serjeant (AUS),1977-1978,3,3,1,1,0,0,1,1 (1ct 0st),0.333,
26,RK Sethi (EAf),1975-1975,3,3,1,1,0,0,1,1 (1ct 0st),0.333,
27,Shadab Kabir (PAK),1996-1996,3,3,1,1,0,0,1,1 (1ct 0st),0.333,
28,Shafiq Ahmed (PAK),1977-1978,3,3,1,1,0,0,1,1 (1ct 0st),0.333,
29,KD Shah (HKG),2014-2018,10,10,1,1,0,0,1,1 (1ct 0st),0.1,
30,Shahidullah (AFG),2022-2022,1,1,1,1,0,0,1,1 (1ct 0st),1.0,
31,Shahid Mahboob (PAK),1982-1984,10,10,1,1,0,0,1,1 (1ct 0st),0.1,
32,Shan Masood (PAK),2019-2019,5,5,1,1,0,0,1,1 (1ct 0st),0.2,
33,R Sharma (HKG),2004-2004,2,2,1,1,0,0,1,1 (1ct 0st),0.5,
34,R Sharma (INDIA),2011-2012,4,4,1,1,0,0,1,1 (1ct 0st),0.25,
35,B Shikongo (NAM),2020-2020,1,1,1,1,0,0,1,1 (1ct 0st),1.0,
36,Shoaib Khan (OMA),2021-2021,2,2,1,1,0,0,1,1 (1ct 0st),0.5,
37,LR Shukla (INDIA),1999-1999,3,3,1,1,0,0,1,1 (1ct 0st),0.333,
38,K Shuttleworth (ENG),1971-1971,1,1,1,1,0,0,1,1 (1ct 0st),1.0,
39,PM Siddle (AUS),2009-2019,18,18,1,1,0,0,1,1 (1ct 0st),0.055,
40,RW Sims (ZIM),2002-2003,3,3,1,1,0,0,1,1 (1ct 0st),0.333,
41,L Sipamla (SA),2020-2021,4,4,1,1,0,0,1,1 (1ct 0st),0.25,
42,MA Small (WI),1984-1984,2,2,1,1,0,0,1,1 (1ct 0st),0.5,
43,MJ Smith (ENG),1973-1974,5,5,1,1,0,0,1,1 (1ct 0st),0.2,
44,NMK Smith (ENG),1996-1996,6,6,1,1,0,0,1,1 (1ct 0st),0.166,
45,JA Snow (ENG),1971-1975,8,8,1,1,0,0,1,1 (1ct 0st),0.125,
46,GS Sobers (WI),1973-1973,1,1,1,1,0,0,1,1 (1ct 0st),1.0,
47,Sohail Fazal (PAK),1989-1989,2,2,1,1,0,0,1,1 (1ct 0st),0.5,
48,D Soraine (CAN),2006-2012,4,4,1,1,0,0,1,1 (1ct 0st),0.25,
49,BB Sran (INDIA),2016-2016,6,6,1,1,0,0,1,1 (1ct 0st),0.166,
0,L Sreekumar (UAE),2015-2016,4,4,1,1,0,0,1,1 (1ct 0st),0.25,
1,S Sriram (INDIA),2000-2004,8,8,1,1,0,0,1,1 (1ct 0st),0.125,
2,KR Stackpole (AUS),1971-1974,6,6,1,1,0,0,1,1 (1ct 0st),0.166,
3,JH Stander (SCOT),2009-2012,5,5,1,1,0,0,1,1 (1ct 0st),0.2,
4,B Stanlake (AUS),2017-2019,7,7,1,1,0,0,1,1 (1ct 0st),0.142,
5,LW Stokkers (NED),2008-2008,1,1,1,1,0,0,1,1 (1ct 0st),1.0,
6,LW Stott (NZ),1979-1979,1,1,1,1,0,0,1,1 (1ct 0st),1.0,
7,CEL Stuart (WI),2001-2001,5,5,1,1,0,0,1,1 (1ct 0st),0.2,
8,ML Su'a (NZ),1992-1995,11,11,1,1,0,0,1,1 (1ct 0st),0.09,
9,R Sudhakar Rao (INDIA),1976-1976,1,1,1,1,0,0,1,1 (1ct 0st),1.0,
10,Syed Maqsood (UAE),2004-2004,2,2,1,1,0,0,1,1 (1ct 0st),0.5,
11,Taijul Islam (BAN),2014-2020,9,9,1,1,0,0,1,1 (1ct 0st),0.111,
12,Talha Jubair (BAN),2002-2003,5,5,1,1,0,0,1,1 (1ct 0st),0.2,
13,Tanbir Hayder (BAN),2016-2016,2,2,1,1,0,0,1,1 (1ct 0st),0.5,
14,Tanvir Ahmed (PAK),2011-2011,2,2,1,1,0,0,1,1 (1ct 0st),0.5,
15,M Theekshana (SL),2021-2022,4,4,1,1,0,0,1,1 (1ct 0st),0.25,
16,GJ Thompson (IRE),2008-2008,3,3,1,1,0,0,1,1 (1ct 0st),0.333,
17,CP Tremain (AUS),2016-2016,4,4,1,1,0,0,1,1 (1ct 0st),0.25,
18,JO Troughton (ENG),2003-2003,5,5,1,1,0,0,1,1 (1ct 0st),0.2,
19,R Trumpelmann (NAM),2021-2021,2,2,1,1,0,0,1,1 (1ct 0st),0.5,
20,AJ Tudor (ENG),2002-2002,3,3,1,1,0,0,1,1 (1ct 0st),0.333,
21,S Tyagi (INDIA),2010-2010,3,3,1,1,0,0,1,1 (1ct 0st),0.333,
22,AJ Tye (AUS),2018-2018,7,7,1,1,0,0,1,1 (1ct 0st),0.142,
23,SD Udal (ENG),1994-2005,11,11,1,1,0,0,1,1 (1ct 0st),0.09,
24,Umair Ali (UAE),2015-2015,2,2,1,1,0,0,1,1 (1ct 0st),0.5,
25,Usman Qadir (PAK),2021-2021,1,1,1,1,0,0,1,1 (1ct 0st),1.0,
26,Usman Salahuddin (PAK),2011-2011,2,2,1,1,0,0,1,1 (1ct 0st),0.5,
27,JN Valentine (CAN),1979-1979,3,3,1,1,0,0,1,1 (1ct 0st),0.333,
28,A van der Merwe (IRE),2010-2011,9,9,1,1,0,0,1,1 (1ct 0st),0.111,
29,VB van Jaarsveld (SA),2009-2009,2,2,1,1,0,0,1,1 (1ct 0st),0.5,
30,PA van Meekeren (NED),2013-2021,7,7,1,1,0,0,1,1 (1ct 0st),0.142,
31,S Vesawkar (NEPAL),2018-2021,4,4,1,1,0,0,1,1 (1ct 0st),0.25,
32,AL Wadekar (INDIA),1974-1974,2,2,1,1,0,0,1,1 (1ct 0st),0.5,
33,I Wardlaw (SCOT),2013-2015,21,21,1,1,0,0,1,1 (1ct 0st),0.047,
34,Washington Sundar (INDIA),2017-2017,1,1,1,1,0,0,1,1 (1ct 0st),1.0,
35,SR Welsh (CAN),2006-2008,3,3,1,1,0,0,1,1 (1ct 0st),0.333,
36,BA Westdijk (NED),2011-2011,4,4,1,1,0,0,1,1 (1ct 0st),0.25,
37,AG Wharf (ENG),2004-2005,12,12,1,1,0,0,1,1 (1ct 0st),0.083,
38,BM Wheeler (NZ),2015-2015,6,6,1,1,0,0,1,1 (1ct 0st),0.166,
39,JJ Whitaker (ENG),1987-1987,2,2,1,1,0,0,1,1 (1ct 0st),0.5,
40,DJ White (NZ),1990-1990,3,3,1,1,0,0,1,1 (1ct 0st),0.333,
41,RGCE Wijesuriya (SL),1982-1985,7,7,1,1,0,0,1,1 (1ct 0st),0.142,
42,P Wilson (AUS),1997-1998,11,11,1,1,0,0,1,1 (1ct 0st),0.09,
43,WA Wisneski (NZ),2000-2000,2,2,1,1,0,0,1,1 (1ct 0st),0.5,
44,DJ Worrall (AUS),2016-2016,3,3,1,1,0,0,1,1 (1ct 0st),0.333,
45,CM Wright (SCOT),2006-2009,18,18,1,1,0,0,1,1 (1ct 0st),0.055,
46,M Yachad (SA),1991-1991,1,1,1,1,0,0,1,1 (1ct 0st),1.0,
47,J Yadav (INDIA),2016-2022,2,2,1,1,0,0,1,1 (1ct 0st),0.5,
48,NS Yadav (INDIA),1986-1987,7,7,1,1,0,0,1,1 (1ct 0st),0.142,
49,SA Yadav (INDIA),2021-2022,4,4,1,1,0,0,1,1 (1ct 0st),0.25,
0,HN Ya France (NAM),2019-2021,9,9,1,1,0,0,1,1 (1ct 0st),0.111,
1,B Yardley (AUS),1978-1983,5,5,1,1,0,0,1,1 (1ct 0st),0.2,
2,WA Young (NZ),2021-2021,2,2,1,1,0,0,1,1 (1ct 0st),0.5,
3,Younis Ahmed (PAK),1987-1987,2,2,1,1,0,0,1,1 (1ct 0st),0.5,
4,Zafar Iqbal (PAK),1995-1995,8,8,1,1,0,0,1,1 (1ct 0st),0.125,
5,Zahid Hussain (CAN),2011-2011,2,2,1,1,0,0,1,1 (1ct 0st),0.5,
6,Sultan Zarawani (UAE),1994-1996,7,7,1,1,0,0,1,1 (1ct 0st),0.142,
7,AK Zesers (AUS),1987-1987,2,2,1,1,0,0,1,1 (1ct 0st),0.5,
8,C Zhuwao (ZIM),2008-2018,9,9,1,1,0,0,1,1 (1ct 0st),0.111,
9,K Zondo (SA),2018-2018,5,5,1,1,0,0,1,1 (1ct 0st),0.2,
10,Zulfiqar Ali (EAf),1975-1975,3,3,1,1,0,0,1,1 (1ct 0st),0.333,
11,ME Sanuth (OMA),2020-2020,3,3,0,0,0,0,0,0,0.0,
12,Aamer Hanif (PAK),1993-1995,5,5,0,0,0,0,0,0,0.0,
13,Aamer Nazir (PAK),1993-1995,9,9,0,0,0,0,0,0,0.0,
14,Aamer Yamin (PAK),2015-2018,4,4,0,0,0,0,0,0,0.0,
15,SA Abbott (AUS),2014-2020,2,2,0,0,0,0,0,0,0.0,
16,Abdul Rehman (UAE),2004-2004,1,1,0,0,0,0,0,0,0.0,
17,S Abid Ali (INDIA),1974-1975,5,5,0,0,0,0,0,0,0.0,
18,Abu Jayed (BAN),2019-2019,2,2,0,0,0,0,0,0,0.0,
19,WA Agar (AUS),2021-2021,2,2,0,0,0,0,0,0,0.0,
20,FS Ahangama (SL),1985-1985,1,1,0,0,0,0,0,0,0.0,
21,Ahmed Kamal (BAN),1999-1999,1,1,0,0,0,0,0,0,0.0,
22,Ahmed Shah (AFG),2009-2009,1,1,0,0,0,0,0,0,0.0,
23,KS Airee (NEPAL),2020-2020,1,1,0,0,0,0,0,0,0.0,
24,Akhtar Sarfraz (PAK),1997-1998,4,4,0,0,0,0,0,0,0.0,
25,Alawi Shukri (UAE),2008-2008,1,1,0,0,0,0,0,0,0.0,
26,GW Aldridge (NZ),2011-2011,2,2,0,0,0,0,0,0,0.0,
27,RP Alexander (USA),2004-2004,2,2,0,0,0,0,0,0,0.0,
28,Kabir Ali (ENG),2005-2006,12,12,0,0,0,0,0,0,0.0,
29,Ali Asad (UAE),2004-2004,2,2,0,0,0,0,0,0,0.0,
30,Ali Khan (USA),2019-2019,1,1,0,0,0,0,0,0,0.0,
31,KN Amalean (SL),1986-1988,7,7,0,0,0,0,0,0,0.0,
32,Aman Ali (UAE),2008-2008,1,1,0,0,0,0,0,0,0.0,
33,Aminul Islam jnr (BAN),1999-1999,1,1,0,0,0,0,0,0,0.0,
34,J Angel (AUS),1994-1995,3,3,0,0,0,0,0,0,0.0,
35,Anisur Rahman (BAN),1995-1998,2,2,0,0,0,0,0,0,0.0,
36,HAG Anthony (WI),1995-1995,3,3,0,0,0,0,0,0,0.0,
37,Anwar Hossain Monir (BAN),2002-2002,1,1,0,0,0,0,0,0,0.0,
38,Anwar Hossain (BAN),2002-2002,1,1,0,0,0,0,0,0,0.0,
39,GJAF Aponso (NED),1996-1996,5,5,0,0,0,0,0,0,0.0,
40,MA Aponso (SL),2016-2018,9,9,0,0,0,0,0,0,0.0,
41,Ariful Haque (BAN),2018-2018,1,1,0,0,0,0,0,0,0.0,
42,Arshad Pervez (PAK),1978-1978,2,2,0,0,0,0,0,0,0.0,
43,B Arun (INDIA),1986-1987,4,4,0,0,0,0,0,0,0.0,
44,Asad Ali (PAK),2013-2013,4,4,0,0,0,0,0,0,0.0,
45,Asghar Ali (UAE),2004-2004,2,2,0,0,0,0,0,0,0.0,
46,Ashfaq Ahmed (PAK),1994-1994,3,3,0,0,0,0,0,0,0.0,
47,Asif Iqbal (1) (UAE),2015-2015,1,1,0,0,0,0,0,0,0.0,
48,Asif Mahmood (PAK),1998-1998,2,2,0,0,0,0,0,0,0.0,
49,Asim Butt (SCOT),1999-1999,5,5,0,0,0,0,0,0,0.0,
0,Asim Saeed (UAE),2004-2004,2,2,0,0,0,0,0,0,0.0,
1,SK Atai (PNG),2019-2019,2,2,0,0,0,0,0,0,0.0,
2,Ata-ur-Rehman (PAK),1992-1996,30,30,0,0,0,0,0,0,0.0,
3,ID Austin (ENG),1998-1999,9,9,0,0,0,0,0,0,0.0,
4,RA Austin (WI),1978-1978,1,1,0,0,0,0,0,0,0.0,
5,Azmat Rana (PAK),1978-1978,2,2,0,0,0,0,0,0,0.0,
6,MD Bailey (NZ),1998-1998,1,1,0,0,0,0,0,0,0.0,
7,LS Baker (WI),2008-2009,8,8,0,0,0,0,0,0,0.0,
8,PJ Bakker (NED),1996-1996,5,5,0,0,0,0,0,0,0.0,
9,S Baksh (CAN),1979-1979,1,1,0,0,0,0,0,0,0.0,
10,KMC Bandara (SL),2016-2016,1,1,0,0,0,0,0,0,0.0,
11,MRCN Bandaratilleke (SL),1998-1998,3,3,0,0,0,0,0,0,0.0,
12,OAC Banks (WI),2003-2005,5,5,0,0,0,0,0,0,0.0,
13,KJ Barnett (ENG),1988-1988,1,1,0,0,0,0,0,0,0.0,
14,DM Basden (BMUDA),2007-2007,2,2,0,0,0,0,0,0,0.0,
15,GR Beard (AUS),1981-1981,2,2,0,0,0,0,0,0,0.0,
16,RR Beaton (WI),2017-2017,2,2,0,0,0,0,0,0,0.0,
17,JE Benjamin (ENG),1994-1995,2,2,0,0,0,0,0,0,0.0,
18,MR Benson (ENG),1986-1986,1,1,0,0,0,0,0,0,0.0,
19,A Bhandari (INDIA),2000-2004,2,2,0,0,0,0,0,0,0.0,
20,LS Bhandari (NEPAL),2018-2018,1,1,0,0,0,0,0,0,0.0,
21,Bhupinder Singh snr (INDIA),1994-1994,2,2,0,0,0,0,0,0,0.0,
22,Bikram Sob (NEPAL),2021-2021,4,4,0,0,0,0,0,0,0.0,
23,MI Black (WI),2001-2001,5,5,0,0,0,0,0,0,0.0,
24,DL Blake (USA),2004-2004,1,1,0,0,0,0,0,0,0.0,
25,G Blakeney (BMUDA),2009-2009,2,2,0,0,0,0,0,0,0.0,
26,A Bohara (NEPAL),2020-2020,2,2,0,0,0,0,0,0,0.0,
27,NE Bonner (WI),2021-2021,3,3,0,0,0,0,0,0,0.0,
28,SG Borthwick (ENG),2011-2011,2,2,0,0,0,0,0,0,0.0,
29,T Bosch (SA),1992-1992,2,2,0,0,0,0,0,0,0.0,
30,GK Bose (INDIA),1974-1974,1,1,0,0,0,0,0,0,0.0,
31,KD Boyce (WI),1973-1975,8,8,0,0,0,0,0,0,0.0,
32,BP Bracewell (NZ),1978-1978,1,1,0,0,0,0,0,0,0.0,
33,GA Briant (ZIM),1993-1993,5,5,0,0,0,0,0,0,0.0,
34,DR Briggs (ENG),2012-2012,1,1,0,0,0,0,0,0,0.0,
35,SA Britton (IRE),2009-2009,1,1,0,0,0,0,0,0,0.0,
36,D Brown (WI),2001-2002,3,3,0,0,0,0,0,0,0.0,
37,BS Browne (WI),1994-1994,4,4,0,0,0,0,0,0,0.0,
38,GK Bruk-Jackson (ZIM),1993-1993,1,1,0,0,0,0,0,0,0.0,
39,CE Bulfin (NZ),1999-1999,2,2,0,0,0,0,0,0,0.0,
40,AJ Burger (NAM),2003-2003,6,6,0,0,0,0,0,0,0.0,
41,AR Butcher (ENG),1980-1980,1,1,0,0,0,0,0,0,0.0,
42,RO Butcher (ENG),1980-1981,3,3,0,0,0,0,0,0,0.0,
43,DK Butler (WI),2005-2006,5,5,0,0,0,0,0,0,0.0,
44,RG Callender (CAN),1979-1979,2,2,0,0,0,0,0,0,0.0,
45,JD Campbell (WI),2019-2019,5,5,0,0,0,0,0,0,0.0,
46,PE Cantrell (NED),1996-1996,5,5,0,0,0,0,0,0,0.0,
47,PH Carlson (AUS),1979-1979,3,3,0,0,0,0,0,0,0.0,
48,BA Carse (ENG),2021-2021,3,3,0,0,0,0,0,0,0.0,
49,NM Carter (SCOT),2013-2013,3,3,0,0,0,0,0,0,0.0,
0,RD Chahar (INDIA),2021-2021,1,1,0,0,0,0,0,0,0.0,
1,SJ Chalmers (SCOT),2009-2009,2,2,0,0,0,0,0,0,0.0,
2,BS Chandrasekhar (INDIA),1976-1976,1,1,0,0,0,0,0,0,0.0,
3,VB Chandrasekhar (INDIA),1988-1990,7,7,0,0,0,0,0,0,0.0,
4,CJD Chappell (CAN),1979-1979,3,3,0,0,0,0,0,0,0.0,
5,G Chapple (ENG),2006-2006,1,1,0,0,0,0,0,0,0.0,
6,M Cheruparambil (HKG),2004-2004,2,2,0,0,0,0,0,0,0.0,
7,MT Chinouya (ZIM),2013-2013,2,2,0,0,0,0,0,0,0.0,
8,K Christie (HKG),2016-2016,1,1,0,0,0,0,0,0,0.0,
9,WM Clark (AUS),1978-1978,2,2,0,0,0,0,0,0,0.0,
10,A Codrington (CAN),2003-2007,9,9,0,0,0,0,0,0,0.0,
11,DJ Colley (AUS),1972-1972,1,1,0,0,0,0,0,0,0.0,
12,BE Congdon (NZ),1973-1978,8,8,0,0,0,0,0,0,0.0,
13,AN Connolly (AUS),1971-1971,1,1,0,0,0,0,0,0,0.0,
14,GA Cope (ENG),1977-1978,2,2,0,0,0,0,0,0,0.0,
15,MJ Cosgrove (AUS),2006-2006,2,2,0,0,0,0,0,0,0.0,
16,CS Cowdrey (ENG),1985-1985,3,3,0,0,0,0,0,0,0.0,
17,MC Cowdrey (ENG),1971-1971,1,1,0,0,0,0,0,0,0.0,
18,RT Crandon (WI),2009-2009,1,1,0,0,0,0,0,0,0.0,
19,FS Crockwell (BMUDA),2009-2009,2,2,0,0,0,0,0,0,0.0,
20,D Daesrath (CAN),2012-2013,3,3,0,0,0,0,0,0,0.0,
21,Danish Aziz (PAK),2021-2021,2,2,0,0,0,0,0,0,0.0,
22,SS Das (INDIA),2001-2002,4,4,0,0,0,0,0,0,0.0,
23,NA David (INDIA),1997-1997,4,4,0,0,0,0,0,0,0.0,
24,RR David (CAN),2008-2010,4,4,0,0,0,0,0,0,0.0,
25,H Davids (SA),2013-2013,1,1,0,0,0,0,0,0,0.0,
26,SG Davies (ZIM),1996-1996,4,4,0,0,0,0,0,0,0.0,
27,IC Davis (AUS),1974-1977,3,3,0,0,0,0,0,0,0.0,
28,Dawlat Ahmadzai (AFG),2009-2010,3,3,0,0,0,0,0,0,0.0,
29,JJ Dawood (CAN),2010-2010,1,1,0,0,0,0,0,0,0.0,
30,LA Dawson (ENG),2016-2018,2,2,0,0,0,0,0,0,0.0,
31,NA de Groot (CAN),2003-2003,6,6,0,0,0,0,0,0,0.0,
32,M de Lange (SA),2012-2016,4,4,0,0,0,0,0,0,0.0,
33,FA Dennis (CAN),1979-1979,3,3,0,0,0,0,0,0,0.0,
34,GN de Silva (SL),1985-1985,3,3,0,0,0,0,0,0,0.0,
35,JI de Villiers (NAM),2020-2020,2,2,0,0,0,0,0,0,0.0,
36,P Dharmani (INDIA),1996-1996,1,1,0,0,0,0,0,0,0.0,
37,R Dhawan (INDIA),2016-2016,3,3,0,0,0,0,0,0,0.0,
38,HS Dhillon (CAN),2006-2006,2,2,0,0,0,0,0,0,0.0,
39,WP Diepeveen (NED),2011-2011,1,1,0,0,0,0,0,0,0.0,
40,Dolar Mahmud (BAN),2008-2009,7,7,0,0,0,0,0,0,0.0,
41,BR Dorey (AUS),2006-2006,4,4,0,0,0,0,0,0,0.0,
42,CRM Douglas (BMUDA),2008-2008,2,2,0,0,0,0,0,0,0.0,
43,SO Dowrich (WI),2019-2019,1,1,0,0,0,0,0,0,0.0,
44,CJ Drum (NZ),1999-1999,4,4,0,0,0,0,0,0,0.0,
45,S Dube (INDIA),2019-2019,1,1,0,0,0,0,0,0,0.0,
46,BM Duckett (ENG),2016-2016,3,3,0,0,0,0,0,0,0.0,
47,DM Dupavillon (SA),2020-2021,2,2,0,0,0,0,0,0,0.0,
48,A Dutt (NED),2021-2022,3,3,0,0,0,0,0,0,0.0,
49,N Dutta (CAN),2013-2013,1,1,0,0,0,0,0,0,0.0,
0,PS Eaglestone (IRE),2008-2008,1,1,0,0,0,0,0,0,0.0,
1,JH Edrich (ENG),1971-1974,5,5,0,0,0,0,0,0,0.0,
2,R Edwards (AUS),1972-1975,9,9,0,0,0,0,0,0,0.0,
3,WJ Edwards (AUS),1975-1975,1,1,0,0,0,0,0,0,0.0,
4,Ehsanul Haque (BAN),2002-2003,5,5,0,0,0,0,0,0,0.0,
5,Ehsan Adil (PAK),2013-2015,6,6,0,0,0,0,0,0,0.0,
6,Elias Sunny (BAN),2011-2012,4,4,0,0,0,0,0,0,0.0,
7,MTG Elliott (AUS),1997-1997,1,1,0,0,0,0,0,0,0.0,
8,Fahad Alhashmi (UAE),2008-2015,5,5,0,0,0,0,0,0,0.0,
9,Fahad Nawaz (UAE),2019-2019,2,2,0,0,0,0,0,0,0.0,
10,Faisal Athar (PAK),2003-2003,1,1,0,0,0,0,0,0,0.0,
11,Fawad Ahmed (AUS),2013-2013,3,3,0,0,0,0,0,0,0.0,
12,Fayyaz Ahmed (UAE),2014-2016,3,3,0,0,0,0,0,0,0.0,
13,FY Fazal (INDIA),2016-2016,1,1,0,0,0,0,0,0,0.0,
14,Fazalhaq Farooqi (AFG),2022-2022,1,1,0,0,0,0,0,0,0.0,
15,Fazl-e-Akbar (PAK),1998-2001,2,2,0,0,0,0,0,0,0.0,
16,N Fernandes (UAE),2008-2008,1,1,0,0,0,0,0,0,0.0,
17,AM Fernando (SL),2017-2021,3,3,0,0,0,0,0,0,0.0,
18,ER Fernando (SL),1975-1975,3,3,0,0,0,0,0,0,0.0,
19,ERNS Fernando (SL),1983-1983,5,5,0,0,0,0,0,0,0.0,
20,MVT Fernando (SL),2017-2019,8,8,0,0,0,0,0,0,0.0,
21,TL Fernando (SL),1989-1989,1,1,0,0,0,0,0,0,0.0,
22,UNK Fernando (SL),1994-1994,2,2,0,0,0,0,0,0,0.0,
23,R Flannigan (SCOT),2010-2010,1,1,0,0,0,0,0,0,0.0,
24,DAG Fletcher (ZIM),1983-1983,6,6,0,0,0,0,0,0,0.0,
25,C Floyd (NED),2022-2022,1,1,0,0,0,0,0,0,0.0,
26,MLC Foster (WI),1973-1973,2,2,0,0,0,0,0,0,0.0,
27,TJ Franklin (NZ),1983-1988,3,3,0,0,0,0,0,0,0.0,
28,Frasat Ali (EAf),1975-1975,3,3,0,0,0,0,0,0,0.0,
29,IS Gallage (SL),1999-2001,3,3,0,0,0,0,0,0,0.0,
30,DJ Gandhi (INDIA),1999-2000,3,3,0,0,0,0,0,0,0.0,
31,D Ganesh (INDIA),1997-1997,1,1,0,0,0,0,0,0,0.0,
32,LV Garrick (WI),2001-2001,3,3,0,0,0,0,0,0,0.0,
33,WT Gavera (PNG),2014-2017,4,4,0,0,0,0,0,0,0.0,
34,RS Ghai (INDIA),1984-1986,6,6,0,0,0,0,0,0,0.0,
35,Gholam Nousher (BAN),1986-1990,9,9,0,0,0,0,0,0,0.0,
36,Ghulam Ali (PAK),1993-1995,3,3,0,0,0,0,0,0,0.0,
37,T Gibbons (BMUDA),2006-2006,2,2,0,0,0,0,0,0,0.0,
38,LR Gibbs (WI),1973-1975,3,3,0,0,0,0,0,0,0.0,
39,PG Gillespie (IRE),2006-2007,4,4,0,0,0,0,0,0,0.0,
40,Golam Faruq (BAN),1986-1990,5,5,0,0,0,0,0,0,0.0,
41,MS Gony (INDIA),2008-2008,2,2,0,0,0,0,0,0,0.0,
42,Y Goonasekera (SL),1983-1983,3,3,0,0,0,0,0,0,0.0,
43,JOA Gordon (CAN),2012-2014,4,4,0,0,0,0,0,0,0.0,
44,BHG Gorlee (NED),2022-2022,3,3,0,0,0,0,0,0,0.0,
45,EL Gouka (NED),1996-1996,3,3,0,0,0,0,0,0,0.0,
46,VD Grandia (NED),2002-2002,1,1,0,0,0,0,0,0,0.0,
47,JP Greaves (WI),2022-2022,3,3,0,0,0,0,0,0,0.0,
48,C Green (AUS),2020-2020,1,1,0,0,0,0,0,0,0.0,
49,AE Greenidge (WI),1978-1978,1,1,0,0,0,0,0,0,0.0,
0,L Gregory (ENG),2021-2021,3,3,0,0,0,0,0,0,0.0,
1,RD Gudhka (KENYA),2011-2011,2,2,0,0,0,0,0,0,0.0,
2,Gulsan Jha (NEPAL),2021-2021,1,1,0,0,0,0,0,0,0.0,
3,C Gunasekara (SL),2022-2022,1,1,0,0,0,0,0,0,0.0,
4,FRMD Gunatilleke (SL),1979-1979,1,1,0,0,0,0,0,0,0.0,
5,AAW Gunawardena (SL),1994-1994,1,1,0,0,0,0,0,0,0.0,
6,SK Gupta (KENYA),1996-2001,10,10,0,0,0,0,0,0,0.0,
7,Gurdeep Singh (KENYA),2013-2013,1,1,0,0,0,0,0,0,0.0,
8,Haafiz Shahid (PAK),1988-1988,3,3,0,0,0,0,0,0,0.0,
9,BG Hadlee (NZ),1975-1975,1,1,0,0,0,0,0,0,0.0,
10,OJ Hairs (SCOT),2010-2010,5,5,0,0,0,0,0,0,0.0,
11,JD Hall (IRE),2010-2010,3,3,0,0,0,0,0,0,0.0,
12,JN Hamilton (WI),2021-2021,1,1,0,0,0,0,0,0,0.0,
13,LJ Hamilton (NZ),2005-2005,2,2,0,0,0,0,0,0,0.0,
14,JR Hammond (AUS),1972-1972,1,1,0,0,0,0,0,0,0.0,
15,JH Hampshire (ENG),1971-1972,3,3,0,0,0,0,0,0,0.0,
16,Hamza Tahir (SCOT),2019-2021,10,10,0,0,0,0,0,0,0.0,
17,KJ Harding (WI),2021-2021,1,1,0,0,0,0,0,0,0.0,
18,Harilal Shah (EAf),1975-1975,3,3,0,0,0,0,0,0,0.0,
19,RT Hart (NZ),1985-1985,1,1,0,0,0,0,0,0,0.0,
20,Harunur Rashid (BAN),1988-1988,2,2,0,0,0,0,0,0,0.0,
21,SM Harwood (AUS),2009-2009,1,1,0,0,0,0,0,0,0.0,
22,Hasan Mahmud (BAN),2021-2021,3,3,0,0,0,0,0,0,0.0,
23,MJ Haslam (NZ),1992-1992,1,1,0,0,0,0,0,0,0.0,
24,Hasti Gul (AFG),2009-2009,2,2,0,0,0,0,0,0,0.0,
25,FC Hayes (ENG),1973-1975,5,5,0,0,0,0,0,0,0.0,
26,RL Hayes (NZ),1995-1995,1,1,0,0,0,0,0,0,0.0,
27,RGA Headley (WI),1973-1973,1,1,0,0,0,0,0,0,0.0,
28,SD Heazlett (AUS),2017-2017,1,1,0,0,0,0,0,0,0.0,
29,R Hekure (PNG),2019-2019,1,1,0,0,0,0,0,0,0.0,
30,CW Henderson (SA),2001-2001,4,4,0,0,0,0,0,0,0.0,
31,CC Henry (CAN),1979-1979,2,2,0,0,0,0,0,0,0.0,
32,H Hiri (PNG),2016-2021,10,10,0,0,0,0,0,0,0.0,
33,VR Hogg (ZIM),1983-1983,2,2,0,0,0,0,0,0,0.0,
34,CK Holder (WI),2021-2021,1,1,0,0,0,0,0,0,0.0,
35,RG Holland (AUS),1985-1985,2,2,0,0,0,0,0,0,0.0,
36,DAW Hollis (BMUDA),2008-2008,1,1,0,0,0,0,0,0,0.0,
37,PA Horne (NZ),1987-1987,4,4,0,0,0,0,0,0,0.0,
38,Hussain Talat (PAK),2019-2019,1,1,0,0,0,0,0,0,0.0,
39,Ilyas Gull (HKG),2004-2004,2,2,0,0,0,0,0,0,0.0,
40,Intikhab Alam (PAK),1973-1976,4,4,0,0,0,0,0,0,0.0,
41,Iqbal Sikander (PAK),1992-1992,4,4,0,0,0,0,0,0,0.0,
42,Irfan Fazil (PAK),2000-2000,1,1,0,0,0,0,0,0,0.0,
43,Irfan Sajid (UAE),2014-2014,1,1,0,0,0,0,0,0,0.0,
44,Ishtiaq Muhammad (HKG),2016-2016,1,1,0,0,0,0,0,0,0.0,
45,VR Iyer (INDIA),2022-2022,2,2,0,0,0,0,0,0,0.0,
46,W Jaffer (INDIA),2006-2006,2,2,0,0,0,0,0,0,0.0,
47,Jahangir Alam Talukdar (BAN),1990-1990,2,2,0,0,0,0,0,0,0.0,
48,JA Jameson (ENG),1973-1975,3,3,0,0,0,0,0,0,0.0,
49,M Jansen (SA),2022-2022,1,1,0,0,0,0,0,0,0.0,
0,Jawahir Shah (EAf),1975-1975,3,3,0,0,0,0,0,0,0.0,
1,PS Jayaprakashdaran (SL),2005-2005,1,1,0,0,0,0,0,0,0.0,
2,RSA Jayasekera (SL),1982-1982,2,2,0,0,0,0,0,0,0.0,
3,NGRP Jayasuriya (SL),2018-2018,2,2,0,0,0,0,0,0,0.0,
4,P Jayawickrama (SL),2021-2021,5,5,0,0,0,0,0,0,0.0,
5,TJ Jenner (AUS),1975-1975,1,1,0,0,0,0,0,0,0.0,
6,KCB Jeremy (WI),2000-2001,6,6,0,0,0,0,0,0,0.0,
7,K Jethi (CAN),2008-2008,3,3,0,0,0,0,0,0,0.0,
8,HR Johnson (USA),2004-2004,2,2,0,0,0,0,0,0,0.0,
9,RL Johnson (ENG),2003-2003,9,9,0,0,0,0,0,0,0.0,
10,RA Jones (NZ),2003-2003,5,5,0,0,0,0,0,0,0.0,
11,SP Jones (ENG),2004-2005,7,7,0,0,0,0,0,0,0.0,
12,C Jonker (SA),2018-2018,2,2,0,0,0,0,0,0,0.0,
13,S Jora (NEPAL),2019-2019,1,1,0,0,0,0,0,0,0.0,
14,D Joseph (CAN),2003-2003,4,4,0,0,0,0,0,0,0.0,
15,Junaid Siddique (UAE),2019-2020,6,6,0,0,0,0,0,0,0.0,
16,Junaid Zia (PAK),2003-2003,4,4,0,0,0,0,0,0,0.0,
17,T Kaitano (ZIM),2022-2022,3,3,0,0,0,0,0,0,0.0,
18,AV Kale (INDIA),2003-2003,1,1,0,0,0,0,0,0,0.0,
19,LWS Kaluperuma (SL),1975-1982,4,4,0,0,0,0,0,0,0.0,
20,Kamran Hussain (PAK),2008-2008,2,2,0,0,0,0,0,0,0.0,
21,K Kamyuka (CAN),2013-2013,1,1,0,0,0,0,0,0,0.0,
22,AL Kandappah (CAN),2007-2007,2,2,0,0,0,0,0,0,0.0,
23,Karim Janat (AFG),2017-2017,1,1,0,0,0,0,0,0,0.0,
24,Kashif Daud (UAE),2021-2021,2,2,0,0,0,0,0,0,0.0,
25,Kashif Raza (PAK),2001-2001,1,1,0,0,0,0,0,0,0.0,
26,F Kasteni (ZIM),2007-2007,3,3,0,0,0,0,0,0,0.0,
27,E Katchay (CAN),2008-2009,5,5,0,0,0,0,0,0,0.0,
28,PHT Kaushal (SL),2015-2015,1,1,0,0,0,0,0,0,0.0,
29,RWT Key (ENG),2003-2004,5,5,0,0,0,0,0,0,0.0,
30,Khalid Khan (HKG),2004-2004,2,2,0,0,0,0,0,0,0.0,
31,Khaliq Dad (AFG),2009-2010,6,6,0,0,0,0,0,0,0.0,
32,GK Khoda (INDIA),1998-1998,2,2,0,0,0,0,0,0,0.0,
33,JP Kotze (NAM),2019-2020,8,8,0,0,0,0,0,0,0.0,
34,SP Krishnamurthi (USA),2021-2021,3,3,0,0,0,0,0,0,0.0,
35,CK Kruger (HKG),2008-2008,2,2,0,0,0,0,0,0,0.0,
36,SC Kuggeleijn (NZ),2017-2017,2,2,0,0,0,0,0,0,0.0,
37,D Lakshan (SL),2021-2021,1,1,0,0,0,0,0,0,0.0,
38,MKGCP Lakshitha (SL),2002-2003,7,7,0,0,0,0,0,0,0.0,
39,AV Lalcheta (OMA),2019-2019,2,2,0,0,0,0,0,0,0.0,
40,SB Lama (HKG),2004-2004,1,1,0,0,0,0,0,0,0.0,
41,GA Lamb (ZIM),2010-2011,15,15,0,0,0,0,0,0,0.0,
42,CB Lambert (USA/WI),1990-2004,12,12,0,0,0,0,0,0,0.0,
43,TJ Laughlin (AUS),1978-1979,6,6,0,0,0,0,0,0,0.0,
44,DV Lawrence (ENG),1991-1991,1,1,0,0,0,0,0,0,0.0,
45,JJC Lawson (WI),2001-2005,10,10,0,0,0,0,0,0,0.0,
46,J Lewis (ENG),2005-2007,13,13,0,0,0,0,0,0,0.0,
47,Liaqat Ali (PAK),1977-1978,3,3,0,0,0,0,0,0,0.0,
48,GFJ Liebenberg (SA),1995-1998,4,4,0,0,0,0,0,0,0.0,
49,TA Lloyd (ENG),1984-1984,3,3,0,0,0,0,0,0,0.0,
0,JN Loftie-Eaton (NAM),2021-2021,1,1,0,0,0,0,0,0,0.0,
1,CH Lonsdale (BMUDA),2007-2007,1,1,0,0,0,0,0,0,0.0,
2,AGR Loudon (ENG),2006-2006,1,1,0,0,0,0,0,0,0.0,
3,J Louw (SA),2008-2008,3,3,0,0,0,0,0,0,0.0,
4,MB Loye (ENG),2007-2007,7,7,0,0,0,0,0,0,0.0,
5,BW Luckhurst (ENG),1975-1975,1,1,0,0,0,0,0,0,0.0,
6,AM McCarthy (WI),2021-2021,2,2,0,0,0,0,0,0,0.0,
7,C McAuslan (HKG),2017-2017,2,2,0,0,0,0,0,0,0.0,
8,PD Macchi (OMA),2021-2021,1,1,0,0,0,0,0,0,0.0,
9,OC McCoy (WI),2018-2018,2,2,0,0,0,0,0,0,0.0,
10,BR McDermott (AUS),2021-2021,2,2,0,0,0,0,0,0,0.0,
11,JA Maclean (AUS),1979-1979,1,1,0,0,0,0,0,0,0.0,
12,H McLeod (EAf),1975-1975,2,2,0,0,0,0,0,0,0.0,
13,NJ MacRae (SCOT),2006-2006,2,2,0,0,0,0,0,0,0.0,
14,DSK Madushanka (SL),2018-2018,1,1,0,0,0,0,0,0,0.0,
15,LD Madushanka (SL),2017-2017,4,4,0,0,0,0,0,0,0.0,
16,Mahbubur Rahman (BAN),1999-1999,1,1,0,0,0,0,0,0,0.0,
17,Mahedi Hasan (BAN),2021-2021,3,3,0,0,0,0,0,0,0.0,
18,Mahmood Hamid (PAK),1995-1995,1,1,0,0,0,0,0,0,0.0,
19,AV Mankad (INDIA),1974-1974,1,1,0,0,0,0,0,0,0.0,
20,Mansoor Amjad (PAK),2008-2008,1,1,0,0,0,0,0,0,0.0,
21,Mansoor Rana (PAK),1990-1990,2,2,0,0,0,0,0,0,0.0,
22,Maqsood Rana (PAK),1990-1990,1,1,0,0,0,0,0,0,0.0,
23,CA Marshall (CAN),1979-1979,2,2,0,0,0,0,0,0,0.0,
24,JAH Marshall (NZ),2005-2008,10,10,0,0,0,0,0,0,0.0,
25,GC Martin (ZIM),1994-1995,5,5,0,0,0,0,0,0,0.0,
26,Masood Iqbal (PAK),1984-1984,1,1,0,0,0,0,0,0,0.0,
27,SJ Massiah (USA),2004-2004,2,2,0,0,0,0,0,0,0.0,
28,PS Masvaure (ZIM),2018-2018,2,2,0,0,0,0,0,0,0.0,
29,AW Mathieson (NZ),2015-2015,1,1,0,0,0,0,0,0,0.0,
30,BM Mauricette (CAN),1979-1979,3,3,0,0,0,0,0,0,0.0,
31,DES Maxwell (CAN),2006-2007,10,10,0,0,0,0,0,0,0.0,
32,KR Mayers (WI),2021-2021,3,3,0,0,0,0,0,0,0.0,
33,Mazharul Haque (BAN),2002-2002,1,1,0,0,0,0,0,0,0.0,
34,GJ McCarter (IRE),2014-2014,1,1,0,0,0,0,0,0,0.0,
35,SC Meaker (ENG),2011-2011,2,2,0,0,0,0,0,0,0.0,
36,Mehmood Quaraishy (EAf),1975-1975,3,3,0,0,0,0,0,0,0.0,
37,PS Mehta (EAf),1975-1975,1,1,0,0,0,0,0,0,0.0,
38,MA Meman (ZIM),1987-1987,1,1,0,0,0,0,0,0,0.0,
39,JM Mennie (AUS),2016-2016,2,2,0,0,0,0,0,0,0.0,
40,RP Meredith (AUS),2021-2021,1,1,0,0,0,0,0,0,0.0,
41,PL Mhambrey (INDIA),1996-1998,2,2,0,0,0,0,0,0,0.0,
42,DJ Mitchell (NZ),2021-2021,3,3,0,0,0,0,0,0,0.0,
43,Mohammad Abbas (PAK),2019-2019,3,3,0,0,0,0,0,0,0.0,
44,Mohammad Aslam (UAE),1996-1996,4,4,0,0,0,0,0,0,0.0,
45,Mohammad Iqbal (CAN),2007-2008,5,5,0,0,0,0,0,0,0.0,
46,Mohammad Nazir (PAK),1980-1984,4,4,0,0,0,0,0,0,0.0,
47,Mohammad Talha (PAK),2014-2014,3,3,0,0,0,0,0,0,0.0,
48,Mohammed Siraj (INDIA),2019-2019,1,1,0,0,0,0,0,0,0.0,
49,Moin-ul-Atiq (PAK),1988-1989,5,5,0,0,0,0,0,0,0.0,
0,Moniruzzaman (BAN),2003-2003,2,2,0,0,0,0,0,0,0.0,
1,DWO Morgan (BMUDA),2006-2006,2,2,0,0,0,0,0,0,0.0,
2,EA Moseley (WI),1990-1991,7,7,0,0,0,0,0,0,0.0,
3,PV Mpitsang (SA),1999-1999,2,2,0,0,0,0,0,0,0.0,
4,Muhammad Musa (PAK),2020-2020,2,2,0,0,0,0,0,0,0.0,
5,Mujahid Jamshed (PAK),1997-1997,4,4,0,0,0,0,0,0,0.0,
6,M Mulla (CAN),2007-2007,1,1,0,0,0,0,0,0,0.0,
7,AMN Munasinghe (SL),1994-1996,5,5,0,0,0,0,0,0,0.0,
8,Munir Dar (HKG),2008-2008,2,2,0,0,0,0,0,0,0.0,
9,GB Murgatroyd (NAM),2003-2003,6,6,0,0,0,0,0,0,0.0,
10,DJ Murray (NZ),1994-1994,1,1,0,0,0,0,0,0,0.0,
11,T Muzarabani (ZIM),2015-2016,8,8,0,0,0,0,0,0,0.0,
12,Nadeem Ghauri (PAK),1990-1990,6,6,0,0,0,0,0,0,0.0,
13,Nadeem Khan (PAK),1993-1995,2,2,0,0,0,0,0,0,0.0,
14,Naeem Ashraf (PAK),1995-1995,2,2,0,0,0,0,0,0,0.0,
15,J Nagenda (EAf),1975-1975,1,1,0,0,0,0,0,0,0.0,
16,SS Naik (INDIA),1974-1974,2,2,0,0,0,0,0,0,0.0,
17,KK Nair (INDIA),2016-2016,2,2,0,0,0,0,0,0,0.0,
18,Najaf Shah (PAK),2007-2007,1,1,0,0,0,0,0,0,0.0,
19,Najeeb Tarakai (AFG),2017-2017,1,1,0,0,0,0,0,0,0.0,
20,DP Nannes (AUS),2009-2009,1,1,0,0,0,0,0,0,0.0,
21,Naseer Malik (PAK),1975-1975,3,3,0,0,0,0,0,0,0.0,
22,Nasim-ul-Ghani (PAK),1973-1973,1,1,0,0,0,0,0,0,0.0,
23,Nasir Aziz (UAE),2014-2015,5,5,0,0,0,0,0,0,0.0,
24,Nasir Hameed (HKG),2004-2004,1,1,0,0,0,0,0,0,0.0,
25,Nasir Javed (USA),2004-2004,1,1,0,0,0,0,0,0,0.0,
26,T Natarajan (INDIA),2020-2021,2,2,0,0,0,0,0,0,0.0,
27,Naumanullah (PAK),2008-2008,1,1,0,0,0,0,0,0,0.0,
28,Naved Anjum (PAK),1984-1992,12,12,0,0,0,0,0,0,0.0,
29,MN Nawaz (SL),1998-2002,3,3,0,0,0,0,0,0,0.0,
30,AM Nayar (INDIA),2009-2009,2,2,0,0,0,0,0,0,0.0,
31,N Ncube (ZIM),2011-2011,1,1,0,0,0,0,0,0,0.0,
32,A Ndlovu (ZIM),2019-2019,2,2,0,0,0,0,0,0,0.0,
33,MG Neser (AUS),2018-2018,2,2,0,0,0,0,0,0,0.0,
34,SO Ngoche (KENYA),2010-2014,14,14,0,0,0,0,0,0,0.0,
35,IA Nicolson (ZIM),2010-2010,2,2,0,0,0,0,0,0,0.0,
36,RG Nijman (NED),2009-2009,1,1,0,0,0,0,0,0,0.0,
37,Nurul Abedin (BAN),1986-1990,4,4,0,0,0,0,0,0,0.0,
38,KJ O'Keeffe (AUS),1977-1977,2,2,0,0,0,0,0,0,0.0,
39,D Olivier (SA),2019-2019,2,2,0,0,0,0,0,0,0.0,
40,DR O'Sullivan (NZ),1974-1976,3,3,0,0,0,0,0,0,0.0,
41,MB Owens (NZ),1992-1992,1,1,0,0,0,0,0,0,0.0,
42,M Panchal (NED),2007-2007,1,1,0,0,0,0,0,0,0.0,
43,GK Pandey (INDIA),1999-1999,2,2,0,0,0,0,0,0,0.0,
44,AA Paradkar (USA),2021-2021,2,2,0,0,0,0,0,0,0.0,
45,BA Parchment (WI),2007-2008,7,7,0,0,0,0,0,0,0.0,
46,SD Parry (ENG),2014-2014,2,2,0,0,0,0,0,0,0.0,
47,Parvez Rasool (INDIA),2014-2014,1,1,0,0,0,0,0,0,0.0,
48,NT Pascal (WI),2009-2009,1,1,0,0,0,0,0,0,0.0,
49,SP Pasqual (SL),1979-1979,2,2,0,0,0,0,0,0,0.0,
0,A Patel (CAN),2003-2003,2,2,0,0,0,0,0,0,0.0,
1,JM Patel (CAN),1979-1979,3,3,0,0,0,0,0,0,0.0,
2,KA Patel (KENYA),2006-2006,2,2,0,0,0,0,0,0,0.0,
3,ML Patel (KENYA),2004-2006,3,3,0,0,0,0,0,0,0.0,
4,RGM Patel (INDIA),1988-1988,1,1,0,0,0,0,0,0,0.0,
5,R Pathan (CAN),2013-2013,1,1,0,0,0,0,0,0,0.0,
6,BMW Patterson (SCOT),1999-1999,3,3,0,0,0,0,0,0,0.0,
7,GE Peckover (ZIM),1983-1983,3,3,0,0,0,0,0,0,0.0,
8,KG Perera (SL),1986-1986,1,1,0,0,0,0,0,0,0.0,
9,A Phillip (WI),2021-2021,1,1,0,0,0,0,0,0,0.0,
10,N Phillip (WI),1978-1978,1,1,0,0,0,0,0,0,0.0,
11,HSM Pieris (SL),1975-1975,3,3,0,0,0,0,0,0,0.0,
12,K Pierre (WI),2019-2020,3,3,0,0,0,0,0,0,0.0,
13,ADJ Pitcher (BMUDA),2007-2007,3,3,0,0,0,0,0,0,0.0,
14,PI Pocock (ENG),1985-1985,1,1,0,0,0,0,0,0,0.0,
15,M Prasidh Krishna (INDIA),2021-2022,4,4,0,0,0,0,0,0,0.0,
16,DJ Pringle (EAf),1975-1975,2,2,0,0,0,0,0,0,0.0,
17,CA Pujara (INDIA),2013-2014,4,4,0,0,0,0,0,0,0.0,
18,Y Punja (UAE),2015-2015,1,1,0,0,0,0,0,0,0.0,
19,M Pushpakumara (SL),2010-2010,2,2,0,0,0,0,0,0,0.0,
20,Qais Ahmad (AFG),2022-2022,1,1,0,0,0,0,0,0,0.0,
21,CT Radley (ENG),1978-1978,4,4,0,0,0,0,0,0,0.0,
22,Rafiqul Alam (BAN),1986-1986,2,2,0,0,0,0,0,0,0.0,
23,Rafiqul Islam (BAN),2002-2002,1,1,0,0,0,0,0,0,0.0,
24,PBB Rajapaksa (SL),2021-2021,5,5,0,0,0,0,0,0,0.0,
25,RR Ramdass (WI),2005-2005,1,1,0,0,0,0,0,0,0.0,
26,D Ramnarine (WI),1997-2001,4,4,0,0,0,0,0,0,0.0,
27,DR Ramsammy (CAN),2012-2012,1,1,0,0,0,0,0,0,0.0,
28,Ramveer Rai (UAE),2004-2004,1,1,0,0,0,0,0,0,0.0,
29,N Rana (INDIA),2021-2021,1,1,0,0,0,0,0,0,0.0,
30,AN Ranasinghe (SL),1975-1982,9,9,0,0,0,0,0,0,0.0,
31,SK Ranasinghe (SL),1986-1986,3,3,0,0,0,0,0,0,0.0,
32,N Ranatunga (SL),1993-1993,2,2,0,0,0,0,0,0,0.0,
33,Randhir Singh (INDIA),1981-1983,2,2,0,0,0,0,0,0,0.0,
34,Rashid Zia (USA),2004-2004,2,2,0,0,0,0,0,0,0.0,
35,NLK Ratnayake (SL),1989-1990,2,2,0,0,0,0,0,0,0.0,
36,SS Raul (INDIA),1998-1998,2,2,0,0,0,0,0,0,0.0,
37,Raza Hasan (PAK),2014-2014,1,1,0,0,0,0,0,0,0.0,
38,RE Redmond (NZ),1973-1973,1,1,0,0,0,0,0,0,0.0,
39,B Regmi (NEPAL),2018-2019,4,4,0,0,0,0,0,0,0.0,
40,CA Reid (USA),2004-2004,2,2,0,0,0,0,0,0,0.0,
41,RA Reifer (WI),2019-2021,5,5,0,0,0,0,0,0,0.0,
42,Riaz Hassan (AFG),2022-2022,1,1,0,0,0,0,0,0,0.0,
43,CEB Rice (SA),1991-1991,3,3,0,0,0,0,0,0,0.0,
44,EJ Richardson (IRE),2013-2013,2,2,0,0,0,0,0,0,0.0,
45,EB Ringera (KENYA),2011-2011,1,1,0,0,0,0,0,0,0.0,
46,HP Rinke (ZIM),2006-2006,17,17,0,0,0,0,0,0,0.0,
47,Rizwan Latif (UAE),2004-2004,1,1,0,0,0,0,0,0,0.0,
48,SJ Roberts (NZ),1990-1990,2,2,0,0,0,0,0,0,0.0,
49,Robiul Islam (BAN),2013-2013,3,3,0,0,0,0,0,0,0.0,
0,TS Roland-Jones (ENG),2017-2017,1,1,0,0,0,0,0,0,0.0,
1,Saad Ali (PAK),2019-2019,2,2,0,0,0,0,0,0,0.0,
2,Saad Nasim (PAK),2015-2015,3,3,0,0,0,0,0,0,0.0,
3,Sagar Pun (NEPAL),2018-2018,1,1,0,0,0,0,0,0,0.0,
4,Saiful Islam (BAN),1990-1997,7,7,0,0,0,0,0,0,0.0,
5,Sajjad Ahmed (BAN),1995-1995,2,2,0,0,0,0,0,0,0.0,
6,Sajjad Akbar (PAK),1990-1990,2,2,0,0,0,0,0,0,0.0,
7,Saleem Pervez (PAK),1980-1980,1,1,0,0,0,0,0,0,0.0,
8,Saleem Raza (UAE),1994-1996,6,6,0,0,0,0,0,0,0.0,
9,Salman Faris (UAE),2014-2014,3,3,0,0,0,0,0,0,0.0,
10,Salman Farooq (UAE),2014-2014,1,1,0,0,0,0,0,0,0.0,
11,PD Salt (ENG),2021-2021,3,3,0,0,0,0,0,0,0.0,
12,Samiullah Khan (PAK),2008-2008,2,2,0,0,0,0,0,0,0.0,
13,Sami Aslam (PAK),2015-2016,4,4,0,0,0,0,0,0,0.0,
14,Sami Faridi (CAN),2008-2008,3,3,0,0,0,0,0,0,0.0,
15,GS Sandhu (AUS),2015-2015,2,2,0,0,0,0,0,0,0.0,
16,Saqib Zulfiqar (NED),2019-2022,7,7,0,0,0,0,0,0,0.0,
17,P Sarraf (NEPAL),2019-2021,3,3,0,0,0,0,0,0,0.0,
18,Saud Shakeel (PAK),2021-2021,3,3,0,0,0,0,0,0,0.0,
19,Sayed Shirzad (AFG),2019-2019,1,1,0,0,0,0,0,0,0.0,
20,RH Scholte (NED),2002-2003,5,5,0,0,0,0,0,0,0.0,
21,BN Schultz (SA),1992-1992,1,1,0,0,0,0,0,0,0.0,
22,GR Sealy (CAN),1979-1979,3,3,0,0,0,0,0,0,0.0,
23,TAP Sekhar (INDIA),1983-1985,4,4,0,0,0,0,0,0,0.0,
24,Shafiuddin Ahmed (BAN),1997-2000,11,11,0,0,0,0,0,0,0.0,
25,Shaheedur Rahman (BAN),1986-1986,2,2,0,0,0,0,0,0,0.0,
26,Shahid Anwar (PAK),1996-1996,1,1,0,0,0,0,0,0,0.0,
27,Shehzad Altaf (UAE),1996-1996,2,2,0,0,0,0,0,0,0.0,
28,Shahzad Khan (CAN),2007-2007,1,1,0,0,0,0,0,0,0.0,
29,Shahzaib Hasan (PAK),2010-2010,3,3,0,0,0,0,0,0,0.0,
30,Shakeel Ahmed jnr (PAK),1995-1995,2,2,0,0,0,0,0,0,0.0,
31,Shakeel Khan (PAK),1987-1987,1,1,0,0,0,0,0,0,0.0,
32,A Shamshudeen (CAN),2007-2007,1,1,0,0,0,0,0,0,0.0,
33,JNK Shannon (IRE),2013-2013,1,1,0,0,0,0,0,0,0.0,
34,A Sharafu (UAE),2021-2021,1,1,0,0,0,0,0,0,0.0,
35,Shariful Haque (BAN),1998-1998,1,1,0,0,0,0,0,0,0.0,
36,PH Sharma (INDIA),1976-1976,2,2,0,0,0,0,0,0,0.0,
37,AP Sheahan (AUS),1972-1972,3,3,0,0,0,0,0,0,0.0,
38,Sheikh Salahuddin (BAN),1997-1997,6,6,0,0,0,0,0,0,0.0,
39,V Shetty (UAE),2008-2014,2,2,0,0,0,0,0,0,0.0,
40,M Shezi (SA),2014-2014,1,1,0,0,0,0,0,0,0.0,
41,S Shivnarine (WI),1978-1978,1,1,0,0,0,0,0,0,0.0,
42,Shoriful Islam (BAN),2021-2021,4,4,0,0,0,0,0,0,0.0,
43,Shubman Gill (INDIA),2019-2020,3,3,0,0,0,0,0,0,0.0,
44,M Shumba (ZIM),2022-2022,1,1,0,0,0,0,0,0,0.0,
45,Shuvagata Hom (BAN),2011-2011,4,4,0,0,0,0,0,0,0.0,
46,JD Siddons (AUS),1988-1988,1,1,0,0,0,0,0,0,0.0,
47,EHSN Silva (UAE),2008-2008,1,1,0,0,0,0,0,0,0.0,
48,KJ Silva (SL),1995-1995,1,1,0,0,0,0,0,0,0.0,
49,CEW Silverwood (ENG),1996-2001,7,7,0,0,0,0,0,0,0.0,
0,Simandeep Singh (HKG),2018-2018,1,1,0,0,0,0,0,0,0.0,
1,G Singh (USA),2021-2021,2,2,0,0,0,0,0,0,0.0,
2,RP Singh (INDIA),1986-1986,1,1,0,0,0,0,0,0,0.0,
3,Skhawat Ali (HKG),2008-2014,4,4,0,0,0,0,0,0,0.0,
4,WN Slack (ENG),1986-1986,2,2,0,0,0,0,0,0,0.0,
5,CL Smith (ENG),1984-1984,4,4,0,0,0,0,0,0,0.0,
6,DM Smith (ENG),1986-1990,2,2,0,0,0,0,0,0,0.0,
7,M Smith (BMUDA),2008-2008,1,1,0,0,0,0,0,0,0.0,
8,MJ Smith (SCOT),1999-1999,5,5,0,0,0,0,0,0,0.0,
9,OF Smith (WI),2022-2022,3,3,0,0,0,0,0,0,0.0,
10,RAJ Smith (SCOT),2016-2016,1,1,0,0,0,0,0,0,0.0,
11,G Snyman (NAM),2003-2003,5,5,0,0,0,0,0,0,0.0,
12,Sohail Butt (UAE),1994-1994,2,2,0,0,0,0,0,0,0.0,
13,S Somasunder (INDIA),1996-1996,2,2,0,0,0,0,0,0,0.0,
14,TE Srinivasan (INDIA),1980-1981,2,2,0,0,0,0,0,0,0.0,
15,RW Staple (USA),2004-2004,2,2,0,0,0,0,0,0,0.0,
16,NA Statham (NED),2003-2009,3,3,0,0,0,0,0,0,0.0,
17,MP Stead (CAN),1979-1979,2,2,0,0,0,0,0,0,0.0,
18,RD Steede (BMUDA),2006-2008,8,8,0,0,0,0,0,0,0.0,
19,DS Steele (ENG),1976-1976,1,1,0,0,0,0,0,0,0.0,
20,SL Stewart (NZ),2010-2010,4,4,0,0,0,0,0,0,0.0,
21,PJR Steyn (SA),1995-1995,1,1,0,0,0,0,0,0,0.0,
22,OP Stone (ENG),2018-2018,3,3,0,0,0,0,0,0,0.0,
23,Subashis Roy (BAN),2016-2016,1,1,0,0,0,0,0,0,0.0,
24,Sufyan Mehmood (OMA),2021-2021,1,1,0,0,0,0,0,0,0.0,
25,Sultan Ahmed (UAE),2019-2019,2,2,0,0,0,0,0,0,0.0,
26,GP Sulzberger (NZ),2000-2000,3,3,0,0,0,0,0,0,0.0,
27,S Sumar (EAf),1975-1975,1,1,0,0,0,0,0,0,0.0,
28,Sunzamul Islam (BAN),2017-2018,3,3,0,0,0,0,0,0,0.0,
29,SJ Swanepoel (NAM),2003-2003,5,5,0,0,0,0,0,0,0.0,
30,Tabarak Dar (HKG),2004-2008,4,4,0,0,0,0,0,0,0.0,
31,AR Tait (NZ),1998-1999,5,5,0,0,0,0,0,0,0.0,
32,Tanvir Mehdi (PAK),1992-1992,1,1,0,0,0,0,0,0,0.0,
33,Tariq Javed (CAN),1979-1979,3,3,0,0,0,0,0,0,0.0,
34,BR Taylor (NZ),1973-1973,1,1,0,0,0,0,0,0,0.0,
35,JP Taylor (ENG),1993-1993,1,1,0,0,0,0,0,0,0.0,
36,LB Taylor (ENG),1986-1986,2,2,0,0,0,0,0,0,0.0,
37,DJ Terbrugge (SA),2000-2000,4,4,0,0,0,0,0,0,0.0,
38,DJ ter Braak (NED),2018-2018,2,2,0,0,0,0,0,0,0.0,
39,VAB Tewarie (NED),2011-2011,1,1,0,0,0,0,0,0,0.0,
40,JG Thomas (ENG),1986-1987,3,3,0,0,0,0,0,0,0.0,
41,O Thomas (WI),2018-2020,18,18,0,0,0,0,0,0,0.0,
42,EP Thompson (NZ),2009-2009,1,1,0,0,0,0,0,0,0.0,
43,PIC Thompson (WI),1997-1997,2,2,0,0,0,0,0,0,0.0,
44,AL Thomson (AUS),1971-1971,1,1,0,0,0,0,0,0,0.0,
45,MH Tissera (SL),1975-1975,3,3,0,0,0,0,0,0,0.0,
46,GC Tonge (WI),2009-2009,5,5,0,0,0,0,0,0,0.0,
47,PM Toohey (AUS),1978-1979,4,4,0,0,0,0,0,0,0.0,
48,GS Trimble (AUS),1986-1986,2,2,0,0,0,0,0,0,0.0,
49,MS Tshabalala (SA),2007-2007,4,4,0,0,0,0,0,0,0.0,
0,CK Tshuma (ZIM),2020-2020,2,2,0,0,0,0,0,0,0.0,
1,CM Tuckett (WI),1998-1998,1,1,0,0,0,0,0,0,0.0,
2,ML Udawatte (SL),2008-2008,8,8,0,0,0,0,0,0,0.0,
3,JD Unadkat (INDIA),2013-2013,6,6,0,0,0,0,0,0,0.0,
4,Usman Mushtaq (UAE),2015-2015,1,1,0,0,0,0,0,0,0.0,
5,T van der Gugten (NED),2012-2021,6,6,0,0,0,0,0,0,0.0,
6,MG Vandort (SL),2006-2006,1,1,0,0,0,0,0,0,0.0,
7,M van Lingen (NAM),2021-2021,2,2,0,0,0,0,0,0,0.0,
8,MWA van Nierop (NED),2006-2006,2,2,0,0,0,0,0,0,0.0,
9,KJJ van Noortwijk (NED),1996-2003,9,9,0,0,0,0,0,0,0.0,
10,BO van Rooi (NAM),2003-2003,3,3,0,0,0,0,0,0,0.0,
11,RJ van Vuuren (NAM),2003-2003,5,5,0,0,0,0,0,0,0.0,
12,CJPG van Zyl (SA),1992-1992,2,2,0,0,0,0,0,0,0.0,
13,JCB Vaughan (CAN),1979-1979,3,3,0,0,0,0,0,0,0.0,
14,M Venkataramana (INDIA),1988-1988,1,1,0,0,0,0,0,0,0.0,
15,GE Vivian (NZ),1973-1973,1,1,0,0,0,0,0,0,0.0,
16,DM Vonhagt (SL),1985-1985,1,1,0,0,0,0,0,0,0.0,
17,Wahidul Gani (BAN),1988-1988,1,1,0,0,0,0,0,0,0.0,
18,KP Walmsley (NZ),2003-2003,2,2,0,0,0,0,0,0,0.0,
19,R Walters (NAM),2003-2003,2,2,0,0,0,0,0,0,0.0,
20,S Walusimbi (EAf),1975-1975,3,3,0,0,0,0,0,0,0.0,
21,Waqas Khan (HKG),2015-2017,7,7,0,0,0,0,0,0,0.0,
22,Wasim Haider (PAK),1992-1992,2,2,0,0,0,0,0,0,0.0,
23,SL Watkin (ENG),1994-1994,4,4,0,0,0,0,0,0,0.0,
24,M Watkinson (ENG),1996-1996,1,1,0,0,0,0,0,0,0.0,
25,GD Watson (AUS),1972-1972,2,2,0,0,0,0,0,0,0.0,
26,RJ Webb (NZ),1983-1983,3,3,0,0,0,0,0,0,0.0,
27,AP Weerakkody (SL),1994-1994,1,1,0,0,0,0,0,0,0.0,
28,S Weerakoon (SL),2012-2012,1,1,0,0,0,0,0,0,0.0,
29,AP Wells (ENG),1995-1995,1,1,0,0,0,0,0,0,0.0,
30,CM Wells (ENG),1985-1985,2,2,0,0,0,0,0,0,0.0,
31,MD Wettimuny (SL),1983-1983,1,1,0,0,0,0,0,0,0.0,
32,SRD Wettimuny (SL),1975-1979,3,3,0,0,0,0,0,0,0.0,
33,K Whatham (CAN),2011-2011,1,1,0,0,0,0,0,0,0.0,
34,DF Whatmore (AUS),1980-1980,1,1,0,0,0,0,0,0,0.0,
35,RK Whelan (IRE),2007-2007,2,2,0,0,0,0,0,0,0.0,
36,RPAH Wickramaratne (SL),1993-1993,2,2,0,0,0,0,0,0,0.0,
37,D Wiese (SA),2015-2016,6,6,0,0,0,0,0,0,0.0,
38,KOK Williams (WI),2017-2018,7,7,0,0,0,0,0,0,0.0,
39,LB Williams (SA),2021-2021,1,1,0,0,0,0,0,0,0.0,
40,JG Williamson (SCOT),1999-1999,2,2,0,0,0,0,0,0,0.0,
41,CM Willoughby (SA),2000-2003,3,3,0,0,0,0,0,0,0.0,
42,AJ Woodcock (AUS),1974-1974,1,1,0,0,0,0,0,0,0.0,
43,LJ Woodcock (NZ),2011-2011,4,4,0,0,0,0,0,0,0.0,
44,T Yohannan (INDIA),2002-2002,3,3,0,0,0,0,0,0,0.0,
45,Yunus Badat (EAf),1975-1975,2,2,0,0,0,0,0,0,0.0,
46,Zafar Gohar (PAK),2015-2015,1,1,0,0,0,0,0,0,0.0,
47,Zaheer Maqsood (UAE),2015-2015,2,2,0,0,0,0,0,0,0.0,
48,Zahid Ahmed (PAK),1987-1987,2,2,0,0,0,0,0,0,0.0,
49,Zahid Razzak (BAN),1988-1990,3,3,0,0,0,0,0,0,0.0,
