,Player,Span,Mat,Inns,Dis,Ct,St,Ct Wk,Ct Fi,MD,D/I,Unnamed: 11
0,MS Dhoni (INDIA),2006-2019,96,96,89,56,33,56,0,5 (5ct 0st),0.927,
1,AB de Villiers (SA),2006-2017,77,77,72,65,7,21,44,4 (4ct 0st),0.935,
2,DA Miller (SA/World),2010-2021,95,95,71,70,1,1,69,4 (4ct 0st),0.747,
3,Mushfiqur Rahim (BAN),2006-2021,97,97,71,42,29,32,10,3 (1ct 2st),0.731,
4,Q de Kock (SA),2012-2021,61,61,64,49,15,49,0,4 (3ct 1st),1.049,
5,MJ Guptill (NZ),2009-2021,110,110,64,64,0,0,64,3 (3ct 0st),0.581,
6,D Ramdin (WI),2006-2019,69,69,62,42,20,42,0,4 (4ct 0st),0.898,
7,Kamran Akmal (PAK),2006-2017,58,58,60,28,32,28,0,4 (0ct 4st),1.034,
8,Mohammad Shahzad (AFG),2010-2021,70,70,58,30,28,30,0,5 (3ct 2st),0.828,
9,Umar Akmal (PAK),2009-2019,84,84,52,50,2,11,39,3 (3ct 0st),0.619,
10,Shoaib Malik (ICC/PAK),2006-2021,123,123,50,50,0,0,50,3 (3ct 0st),0.406,
11,JC Buttler (ENG),2011-2021,86,86,49,39,10,37,2,3 (3ct 0st),0.569,
12,Mohammad Nabi (AFG),2010-2021,86,86,47,47,0,0,47,3 (3ct 0st),0.546,
13,TG Southee (NZ),2008-2021,90,90,47,47,0,0,47,2 (2ct 0st),0.522,
14,DA Warner (AUS),2009-2021,86,86,47,47,0,0,47,3 (3ct 0st),0.546,
15,EJG Morgan (ENG),2009-2022,112,112,46,46,0,0,46,3 (3ct 0st),0.41,
16,Sarfaraz Ahmed (PAK),2010-2021,61,61,46,36,10,36,0,3 (3ct 0st),0.754,
17,LRPL Taylor (NZ),2006-2020,100,100,46,46,0,0,46,3 (3ct 0st),0.46,
18,GC Wilson (IRE),2008-2020,76,76,46,39,7,29,10,4 (3ct 1st),0.605,
19,MH Cross (SCOT),2013-2021,54,54,45,31,14,31,0,4 (3ct 1st),0.833,
20,RG Sharma (INDIA),2007-2021,117,117,45,45,0,0,45,3 (3ct 0st),0.384,
21,JM Bairstow (ENG),2011-2021,61,61,44,43,1,12,31,2 (2ct 0st),0.721,
22,DJ Bravo (WI),2006-2021,85,85,44,44,0,0,44,3 (3ct 0st),0.517,
23,BB McCullum (NZ),2005-2015,69,69,43,35,8,24,11,3 (3ct 0st),0.623,
24,KC Sangakkara (SL),2006-2014,55,55,43,23,20,23,0,3 (2ct 1st),0.781,
25,SK Raina (INDIA),2006-2018,78,78,42,42,0,0,42,3 (3ct 0st),0.538,
26,GH Dockrell (IRE),2010-2021,80,80,41,41,0,0,41,3 (3ct 0st),0.512,
27,V Kohli (INDIA),2010-2021,92,92,41,41,0,0,41,3 (3ct 0st),0.445,
28,Mahmudullah (BAN),2007-2021,111,111,41,41,0,0,41,3 (3ct 0st),0.369,
29,CJ Jordan (ENG),2014-2022,74,74,40,40,0,0,40,3 (3ct 0st),0.54,
30,KJ O'Brien (IRE),2008-2021,103,103,40,40,0,0,40,2 (2ct 0st),0.388,
31,KA Pollard (WI),2008-2022,90,90,40,40,0,0,40,2 (2ct 0st),0.444,
32,LD Chandimal (SL),2010-2021,60,60,38,33,5,15,18,4 (4ct 0st),0.633,
33,GJ Maxwell (AUS),2012-2021,78,78,38,38,0,0,38,2 (2ct 0st),0.487,
34,MS Wade (AUS),2011-2021,55,55,38,35,3,35,0,3 (2ct 1st),0.69,
35,IA Karim (KENYA),2013-2021,28,28,37,26,11,24,2,5 (5ct 0st),1.321,
36,AJ Finch (AUS),2011-2021,81,81,36,36,0,0,36,3 (3ct 0st),0.444,
37,BN Cooper (NED),2013-2021,57,57,35,35,0,0,35,3 (3ct 0st),0.614,
38,JP Duminy (SA),2007-2019,80,80,35,35,0,0,35,2 (2ct 0st),0.437,
39,CS MacLeod (SCOT),2009-2021,60,60,35,35,0,0,35,4 (4ct 0st),0.583,
40,LMP Simmons (WI),2007-2021,64,64,35,35,0,1,34,3 (3ct 0st),0.546,
41,Babar Azam (PAK),2016-2021,68,68,34,34,0,0,34,2 (2ct 0st),0.5,
42,Fakhar Zaman (PAK),2017-2021,59,59,34,34,0,0,34,2 (2ct 0st),0.576,
43,Mohammad Rizwan (PAK),2015-2021,50,50,34,28,6,26,2,3 (3ct 0st),0.68,
44,HH Pandya (INDIA),2016-2021,54,54,34,34,0,0,34,2 (2ct 0st),0.629,
45,SPD Smith (AUS),2010-2021,51,51,34,34,0,0,34,2 (2ct 0st),0.666,
46,KS Williamson (NZ),2011-2021,73,73,34,34,0,0,34,3 (3ct 0st),0.465,
47,TM Dilshan (SL),2006-2016,79,79,33,31,2,5,26,2 (2ct 0st),0.417,
48,Soumya Sarkar (BAN),2015-2021,65,65,33,33,0,0,33,2 (2ct 0st),0.507,
49,AD Hales (ENG),2011-2019,58,58,32,32,0,0,32,2 (2ct 0st),0.551,
0,N Pooran (WI),2016-2022,49,49,32,27,5,22,5,3 (3ct 0st),0.653,
1,PM Seelaar (NED),2008-2021,75,75,32,32,0,0,32,2 (2ct 0st),0.426,
2,Najibullah Zadran (AFG),2012-2021,68,68,31,31,0,0,31,2 (2ct 0st),0.455,
3,DJG Sammy (WI/World),2007-2017,66,66,31,31,0,0,31,4 (4ct 0st),0.469,
4,SA Edwards (NED),2018-2021,35,35,30,26,4,26,0,3 (3ct 0st),0.857,
5,Mohammad Hafeez (PAK),2006-2021,115,115,30,30,0,0,30,2 (2ct 0st),0.26,
6,L Ronchi (AUS/ICC/NZ),2008-2018,33,33,30,24,6,24,0,3 (3ct 0st),0.909,
7,Shahid Afridi (ICC/PAK),2006-2018,99,99,30,30,0,0,30,3 (3ct 0st),0.303,
8,NLTC Perera (ICC/SL/World),2010-2021,83,83,29,29,0,0,29,2 (2ct 0st),0.349,
9,PW Borren (NED),2008-2017,41,41,28,28,0,0,28,4 (4ct 0st),0.682,
10,AT Carey (AUS),2018-2021,36,36,28,19,9,14,5,3 (3ct 0st),0.777,
11,W Barresi (NED),2012-2019,40,40,27,26,1,26,0,4 (4ct 0st),0.675,
12,TL Seifert (NZ),2018-2021,39,39,27,21,6,21,0,3 (3ct 0st),0.692,
13,NL McCullum (NZ),2007-2016,62,62,26,26,0,0,26,3 (3ct 0st),0.419,
14,NJ O'Brien (IRE),2008-2016,26,26,26,17,9,15,2,4 (3ct 1st),1.0,
15,MJ Santner (NZ),2015-2021,60,60,26,26,0,0,26,3 (3ct 0st),0.433,
16,AC Agar (AUS),2016-2021,39,39,25,25,0,0,25,3 (3ct 0st),0.641,
17,A Balbirnie (IRE),2015-2021,56,56,25,25,0,0,25,2 (2ct 0st),0.446,
18,H Masakadza (ZIM),2006-2019,66,66,25,25,0,0,25,3 (3ct 0st),0.378,
19,Sabbir Rahman (BAN),2014-2019,43,43,25,25,0,0,25,3 (3ct 0st),0.581,
20,PR Stirling (IRE),2009-2021,90,90,25,25,0,0,25,3 (3ct 0st),0.277,
21,F du Plessis (SA/World),2012-2020,50,50,24,24,0,0,24,2 (2ct 0st),0.48,
22,ZE Green (NAM),2019-2021,27,27,24,19,5,19,0,4 (3ct 1st),0.888,
23,DJ Hussey (AUS),2008-2012,38,38,24,24,0,0,24,2 (2ct 0st),0.631,
24,H Klaasen (SA),2018-2021,28,28,24,21,3,13,8,2 (2ct 0st),0.857,
25,AD Mathews (SL),2009-2021,77,77,24,24,0,0,24,2 (2ct 0st),0.311,
26,Mohammed Rizlan (QAT),2019-2021,26,26,24,14,10,14,0,3 (2ct 1st),0.923,
27,R Mutumbami (ZIM),2015-2021,27,27,24,20,4,16,4,4 (4ct 0st),0.888,
28,ADS Fletcher (WI),2008-2021,49,49,23,22,1,10,12,3 (2ct 1st),0.469,
29,BJ Haddin (AUS),2006-2014,34,34,23,17,6,17,0,3 (3ct 0st),0.676,
30,Nurul Hasan (BAN),2016-2021,30,30,23,16,7,16,0,3 (3ct 0st),0.766,
31,CO Obuya (KENYA),2007-2021,41,41,23,23,0,0,23,2 (2ct 0st),0.56,
32,L Siaka (PNG),2015-2021,28,28,23,23,0,0,23,4 (4ct 0st),0.821,
33,SR Thompson (IRE),2014-2019,39,39,23,23,0,0,23,3 (3ct 0st),0.589,
34,CL White (AUS),2007-2014,46,46,23,23,0,0,23,2 (2ct 0st),0.5,
35,E Chigumbura (ZIM),2006-2020,57,57,22,22,0,0,22,2 (2ct 0st),0.385,
36,KJ Coetzer (SCOT),2008-2021,68,68,22,22,0,0,22,2 (2ct 0st),0.323,
37,RA Jadeja (INDIA),2009-2021,54,54,22,22,0,0,22,2 (2ct 0st),0.407,
38,Nizakat Khan (HKG),2014-2020,43,43,22,22,0,0,22,2 (2ct 0st),0.511,
39,MDKJ Perera (SL),2013-2021,59,59,22,16,6,10,6,3 (2ct 1st),0.372,
40,Shakib Al Hasan (BAN),2006-2021,93,93,22,22,0,0,22,2 (2ct 0st),0.236,
41,BRM Taylor (ZIM),2006-2021,45,45,22,20,2,17,3,3 (3ct 0st),0.488,
42,FA Allen (WI),2018-2022,31,31,21,21,0,0,21,2 (2ct 0st),0.677,
43,SCJ Broad (ENG),2006-2014,53,53,21,21,0,0,21,3 (3ct 0st),0.396,
44,RP Burl (ZIM),2018-2021,34,34,21,21,0,0,21,3 (3ct 0st),0.617,
45,MG Erasmus (NAM),2019-2021,30,30,21,21,0,0,21,4 (4ct 0st),0.7,
46,MA Leask (SCOT),2013-2021,41,41,21,21,0,0,21,3 (3ct 0st),0.512,
47,Liton Das (BAN),2015-2021,46,46,21,20,1,2,18,3 (3ct 0st),0.456,
48,SL Malinga (SL),2006-2020,83,83,21,21,0,0,21,2 (2ct 0st),0.253,
49,GD Phillips (NZ),2017-2021,33,33,21,19,2,7,12,4 (3ct 1st),0.636,
0,KL Rahul (INDIA),2016-2021,53,53,21,20,1,4,16,2 (2ct 0st),0.396,
1,Shadab Khan (PAK),2017-2021,59,59,21,21,0,0,21,3 (3ct 0st),0.355,
2,Sikandar Raza (ZIM),2013-2021,42,42,21,21,0,0,21,3 (3ct 0st),0.5,
3,Asghar Afghan (AFG),2010-2021,75,75,20,20,0,0,20,2 (2ct 0st),0.266,
4,B Bhandari (NEPAL),2014-2021,35,35,20,12,8,9,3,3 (3ct 0st),0.571,
5,C de Grandhomme (NZ),2012-2021,41,41,20,20,0,0,20,4 (4ct 0st),0.487,
6,JSE Dunford (JER),2019-2021,23,23,20,9,11,9,0,4 (1ct 3st),0.869,
7,Gulbadin Naib (AFG),2012-2021,53,53,20,20,0,0,20,2 (2ct 0st),0.377,
8,MEK Hussey (AUS),2005-2012,38,38,20,20,0,0,20,3 (3ct 0st),0.526,
9,WTS Porterfield (IRE),2008-2018,57,57,20,20,0,0,20,2 (2ct 0st),0.35,
10,Rashid Khan (AFG/ICC),2015-2021,56,56,20,20,0,0,20,2 (2ct 0st),0.357,
11,RE van der Merwe (NED/SA),2009-2021,45,45,20,20,0,0,20,2 (2ct 0st),0.444,
12,SC Williams (ZIM),2006-2021,50,50,20,20,0,0,20,2 (2ct 0st),0.4,
13,HM Amla (SA/World),2009-2018,43,43,19,19,0,0,19,2 (2ct 0st),0.441,
14,CJ Anderson (NZ),2012-2018,30,30,19,19,0,0,19,4 (4ct 0st),0.633,
15,SW Billings (ENG/ICC),2015-2022,36,36,19,17,2,4,13,3 (2ct 1st),0.527,
16,MV Boucher (SA),2005-2010,25,25,19,18,1,18,0,3 (3ct 0st),0.76,
17,S Dhawan (INDIA),2011-2021,66,66,19,19,0,0,19,2 (2ct 0st),0.287,
18,CH Gayle (WI),2006-2021,73,73,19,19,0,0,19,2 (2ct 0st),0.26,
19,C Munro (NZ),2012-2020,63,63,19,19,0,0,19,2 (2ct 0st),0.301,
20,HG Munsey (SCOT),2015-2021,49,49,19,19,0,0,19,3 (3ct 0st),0.387,
21,RR Pant (INDIA),2017-2021,39,39,19,12,7,10,2,2 (2ct 0st),0.487,
22,RR Patel (KENYA),2008-2021,36,36,19,19,0,0,19,3 (3ct 0st),0.527,
23,Samiullah Shinwari (AFG),2010-2020,64,64,19,19,0,0,19,1 (1ct 0st),0.296,
24,SR Watson (AUS),2006-2016,57,57,19,19,0,0,19,2 (2ct 0st),0.333,
25,CR Brathwaite (WI),2011-2019,39,39,18,18,0,0,18,2 (2ct 0st),0.461,
26,Hamza Tariq (CAN),2013-2021,20,20,18,12,6,12,0,3 (3ct 0st),0.9,
27,JO Holder (WI),2014-2022,32,32,18,18,0,0,18,2 (2ct 0st),0.562,
28,Imad Wasim (PAK),2015-2021,56,56,18,18,0,0,18,2 (2ct 0st),0.321,
29,JW Jenner (JER),2019-2021,23,23,18,18,0,0,18,4 (4ct 0st),0.782,
30,KD Karthik (ICC/INDIA),2006-2019,30,30,18,13,5,6,7,3 (3ct 0st),0.6,
31,C Kieswetter (ENG),2010-2012,23,23,18,15,3,15,0,3 (2ct 1st),0.782,
32,JE Root (ENG),2012-2019,32,32,18,18,0,0,18,2 (2ct 0st),0.562,
33,GC Smith (SA),2005-2011,33,33,18,18,0,0,18,2 (2ct 0st),0.545,
34,IS Sodhi (NZ),2014-2021,64,64,18,18,0,0,18,2 (2ct 0st),0.281,
35,Tamim Iqbal (BAN/ICC/World),2007-2020,76,76,18,18,0,0,18,2 (2ct 0st),0.236,
36,Umar Gul (PAK),2007-2016,60,60,18,18,0,0,18,2 (2ct 0st),0.3,
37,JJ Atkinson (HKG),2014-2020,17,17,17,17,0,14,3,3 (3ct 0st),1.0,
38,J Botha (SA),2006-2012,39,39,17,17,0,0,17,2 (2ct 0st),0.435,
39,AC Gilchrist (AUS),2005-2008,13,13,17,17,0,17,0,4 (4ct 0st),1.307,
40,RR Hendricks (SA),2014-2021,40,40,17,17,0,0,17,2 (2ct 0st),0.425,
41,Jatinder Singh (OMA),2015-2021,31,31,17,17,0,0,17,2 (2ct 0st),0.548,
42,DPMD Jayawardene (SL),2006-2014,55,55,17,17,0,0,17,2 (2ct 0st),0.309,
43,CK Kapugedera (SL),2006-2017,43,43,17,17,0,0,17,3 (3ct 0st),0.395,
44,KMDN Kulasekara (SL),2008-2017,57,57,17,17,0,0,17,2 (2ct 0st),0.298,
45,Mohammad Naim (BAN),2019-2021,32,32,17,17,0,0,17,2 (2ct 0st),0.531,
46,JA Morkel (SA),2005-2015,49,49,17,17,0,0,17,2 (2ct 0st),0.346,
47,AU Rashid (ENG),2009-2022,72,72,17,17,0,0,17,2 (2ct 0st),0.236,
48,Rohan Mustafa (UAE),2014-2021,45,45,17,17,0,0,17,2 (2ct 0st),0.377,
49,MD Shanaka (SL),2015-2021,56,56,17,17,0,0,17,3 (3ct 0st),0.303,
0,BDH Stevens (JER),2019-2019,17,17,17,17,0,0,17,3 (3ct 0st),1.0,
1,Sultan Ahmed (OMA),2015-2017,16,16,17,14,3,14,0,3 (3ct 0st),1.062,
2,LJ Tucker (IRE),2016-2021,22,22,17,16,1,6,10,3 (2ct 1st),0.772,
3,Babar Hayat (HKG),2014-2017,24,24,16,16,0,0,16,4 (4ct 0st),0.666,
4,TA Boult (NZ),2013-2021,44,44,16,16,0,0,16,3 (3ct 0st),0.363,
5,SS Cottrell (WI),2014-2022,35,35,16,16,0,0,16,2 (2ct 0st),0.457,
6,K Doriga (PNG),2019-2021,21,21,16,15,1,15,0,5 (5ct 0st),0.761,
7,CR Ervine (ZIM),2010-2021,34,34,16,16,0,0,16,3 (3ct 0st),0.47,
8,P Khadka (NEPAL),2014-2020,32,32,16,16,0,0,16,3 (3ct 0st),0.5,
9,G Malla (NEPAL),2014-2021,31,31,16,16,0,0,16,3 (3ct 0st),0.516,
10,AK Markram (SA),2019-2021,20,20,16,16,0,0,16,2 (2ct 0st),0.8,
11,Nawroz Mangal (AFG),2010-2017,32,32,16,16,0,0,16,3 (3ct 0st),0.5,
12,R Powell (WI),2017-2022,34,34,16,16,0,0,16,2 (2ct 0st),0.47,
13,AD Russell (WI),2011-2021,61,61,16,16,0,0,16,2 (2ct 0st),0.262,
14,Shafiqullah (AFG),2010-2019,46,46,16,14,2,1,13,3 (3ct 0st),0.347,
15,F Achelam (UGA),2019-2021,22,22,15,10,5,10,0,4 (3ct 1st),0.681,
16,Ahmed Raza (UAE),2014-2021,44,44,15,15,0,0,15,2 (2ct 0st),0.34,
17,Ahmed Shehzad (PAK),2009-2019,59,59,15,15,0,0,15,2 (2ct 0st),0.254,
18,TC Bruce (NZ),2017-2020,16,16,15,15,0,1,14,3 (3ct 0st),0.937,
19,S Chandramohan (SGP),2019-2020,15,15,15,15,0,0,15,3 (3ct 0st),1.0,
20,Ghulam Shabber (UAE),2016-2019,17,17,15,14,1,14,0,2 (2ct 0st),0.882,
21,Manpreet Singh (ITA),2019-2021,13,13,15,10,5,10,0,4 (3ct 1st),1.153,
22,S Nadigotla (ROM),2019-2021,10,10,15,10,5,10,0,3 (3ct 0st),1.5,
23,Nasir Hossain (BAN),2011-2016,30,30,15,15,0,0,15,2 (2ct 0st),0.5,
24,MD Patel (USA),2019-2021,15,15,15,7,8,6,1,3 (2ct 1st),1.0,
25,SW Poynter (IRE),2015-2019,23,23,15,13,2,8,5,2 (2ct 0st),0.652,
26,AM Rahane (INDIA),2011-2016,19,19,15,15,0,0,15,4 (4ct 0st),0.789,
27,WB Rankin (ENG/IRE),2009-2020,47,47,15,15,0,0,15,2 (2ct 0st),0.319,
28,DMW Rawlins (BMUDA),2019-2021,16,16,15,15,0,0,15,3 (3ct 0st),0.937,
29,MJ Richardson (GER),2019-2021,11,11,15,8,7,8,0,4 (2ct 2st),1.363,
30,JJ Roy (ENG),2014-2022,58,58,15,15,0,0,15,2 (2ct 0st),0.258,
31,BA Stokes (ENG),2011-2021,33,33,15,15,0,0,15,3 (3ct 0st),0.454,
32,PA van Meekeren (NED),2013-2021,44,44,15,15,0,0,15,2 (2ct 0st),0.34,
33,Virandeep Singh (MAL),2019-2021,25,25,15,11,4,4,7,2 (2ct 0st),0.6,
34,DJ Willey (ENG),2015-2021,32,32,15,15,0,0,15,2 (2ct 0st),0.468,
35,F Behardien (SA),2012-2018,38,38,14,14,0,0,14,2 (2ct 0st),0.368,
36,PD Collingwood (ENG/World),2005-2017,34,34,14,14,0,0,14,2 (2ct 0st),0.411,
37,JH Davey (SCOT),2012-2021,27,27,14,14,0,0,14,2 (2ct 0st),0.518,
38,V Ganesan (GER),2019-2021,20,20,14,14,0,0,14,3 (3ct 0st),0.7,
39,SO Hetmyer (WI),2018-2021,37,37,14,14,0,0,14,2 (2ct 0st),0.378,
40,Iqbal Hussain (QAT),2019-2021,26,26,14,14,0,0,14,3 (3ct 0st),0.538,
41,E Lewis (WI),2016-2021,47,47,14,14,0,0,14,2 (2ct 0st),0.297,
42,DJ Malan (ENG),2017-2021,35,35,14,14,0,0,14,2 (2ct 0st),0.4,
43,Misbah-ul-Haq (PAK),2007-2012,39,39,14,14,0,0,14,2 (2ct 0st),0.358,
44,Mohammad Nawaz (3) (PAK),2016-2021,30,30,14,14,0,0,14,2 (2ct 0st),0.466,
45,SO Ngoche (KENYA),2010-2021,40,40,14,14,0,0,14,2 (2ct 0st),0.35,
46,MP O'Dowd (NED),2015-2021,42,42,14,14,0,0,14,2 (2ct 0st),0.333,
47,KP Pietersen (ENG),2005-2012,35,35,14,14,0,0,14,3 (3ct 0st),0.4,
48,MP Stoinis (AUS),2015-2021,34,34,14,14,0,0,14,2 (2ct 0st),0.411,
49,HT Tector (IRE),2019-2021,27,27,14,14,0,0,14,2 (2ct 0st),0.518,
0,A Vala (PNG),2015-2021,30,30,14,14,0,0,14,3 (3ct 0st),0.466,
1,J Vira (VAN),2019-2019,14,14,14,10,4,10,0,3 (3ct 0st),1.0,
2,CAK Walton (WI),2014-2018,18,18,14,12,2,9,3,3 (3ct 0st),0.777,
3,LJ Wright (ENG),2007-2014,47,47,14,14,0,0,14,2 (2ct 0st),0.297,
4,Ahsan Malik (NED),2012-2017,30,30,13,13,0,0,13,2 (2ct 0st),0.433,
5,MM Ali (ENG),2014-2022,48,48,13,13,0,0,13,2 (2ct 0st),0.27,
6,Awais Ahmed (ESP),2019-2021,14,14,13,10,3,10,0,4 (3ct 1st),0.928,
7,MJ Clarke (AUS),2005-2010,33,33,13,13,0,0,13,2 (2ct 0st),0.393,
8,NM Coulter-Nile (AUS),2013-2019,27,27,13,13,0,0,13,2 (2ct 0st),0.481,
9,N Dickwella (SL),2016-2021,28,28,13,12,1,11,1,2 (2ct 0st),0.464,
10,JEC Franklin (NZ),2006-2013,36,36,13,13,0,0,13,2 (2ct 0st),0.361,
11,MD Gunathilaka (SL),2016-2021,29,29,13,13,0,0,13,3 (3ct 0st),0.448,
12,Manpreet Singh (SGP),2019-2020,15,15,13,7,6,7,0,2 (2ct 0st),0.866,
13,MR Marsh (AUS),2011-2021,36,36,13,13,0,0,13,2 (2ct 0st),0.361,
14,Mustafizur Rahman (BAN),2015-2021,61,61,13,13,0,0,13,3 (3ct 0st),0.213,
15,MA Ouma (KENYA),2007-2013,22,22,13,8,5,8,0,2 (2ct 0st),0.59,
16,TD Paine (AUS/World),2010-2017,11,11,13,11,2,11,0,3 (3ct 0st),1.181,
17,SP Patil (UAE),2014-2016,18,18,13,9,4,9,0,2 (2ct 0st),0.722,
18,A Shreshta (NGA),2021-2021,12,12,13,12,1,12,0,3 (3ct 0st),1.083,
19,MA Starc (AUS),2012-2021,47,47,13,13,0,0,13,2 (2ct 0st),0.276,
20,Sultan Ahmed (UAE),2017-2021,22,22,13,13,0,0,13,3 (3ct 0st),0.59,
21,Tamoor Sajjad (QAT),2019-2020,16,16,13,13,0,0,13,2 (2ct 0st),0.812,
22,Aamir Kaleem (OMA),2015-2020,27,27,12,12,0,0,12,2 (2ct 0st),0.444,
23,Asif Ali (PAK),2018-2021,37,37,12,12,0,0,12,1 (1ct 0st),0.324,
24,O Bascome (BMUDA),2019-2021,16,16,12,9,3,7,2,3 (1ct 2st),0.75,
25,MS Chapman (HKG/NZ),2014-2021,33,33,12,12,0,0,12,2 (2ct 0st),0.363,
26,J Charles (WI),2011-2016,32,32,12,10,2,0,10,2 (2ct 0st),0.375,
27,DP Conway (NZ),2020-2021,19,19,12,11,1,5,6,2 (2ct 0st),0.631,
28,TH David (SGP),2019-2020,14,14,12,12,0,0,12,4 (4ct 0st),0.857,
29,Faheem Ashraf (PAK),2017-2021,42,42,12,12,0,0,12,2 (2ct 0st),0.285,
30,JN Frylinck (NAM),2019-2021,27,27,12,12,0,0,12,2 (2ct 0st),0.444,
31,Khawar Ali (OMA),2015-2021,33,33,12,12,0,0,12,2 (2ct 0st),0.363,
32,WP Masakadza (ZIM),2015-2021,28,28,12,12,0,0,12,3 (3ct 0st),0.428,
33,SS McKechnie (HKG),2019-2020,19,19,12,7,5,7,0,3 (1ct 2st),0.631,
34,DJ Mitchell (NZ),2019-2021,24,24,12,12,0,0,12,2 (2ct 0st),0.5,
35,Mohamed Azzam (Mald),2019-2021,14,14,12,11,1,11,0,3 (3ct 0st),0.857,
36,Muhammad Usman (UAE),2016-2021,43,43,12,12,0,0,12,2 (2ct 0st),0.279,
37,Nadeem Ahmed (HKG),2014-2017,24,24,12,12,0,0,12,2 (2ct 0st),0.5,
38,JDP Oram (NZ),2005-2012,35,35,12,12,0,0,12,2 (2ct 0st),0.342,
39,K Rabada (SA),2014-2021,40,40,12,12,0,0,12,1 (1ct 0st),0.3,
40,Ravinderpal Singh (CAN),2019-2021,17,17,12,12,0,0,12,3 (3ct 0st),0.705,
41,KW Richardson (AUS),2014-2021,25,25,12,12,0,0,12,2 (2ct 0st),0.48,
42,NA Rock (IRE),2021-2021,13,13,12,10,2,10,0,2 (2ct 0st),0.923,
43,Saeed Ajmal (PAK),2009-2015,64,64,12,12,0,0,12,2 (2ct 0st),0.187,
44,MN Samuels (WI),2007-2018,65,65,12,12,0,0,12,2 (2ct 0st),0.184,
45,V Sibanda (ZIM),2007-2016,26,26,12,12,0,0,12,3 (3ct 0st),0.461,
46,JJ Smit (NAM),2019-2021,26,26,12,12,0,0,12,3 (3ct 0st),0.461,
47,DW Steyn (SA),2007-2020,46,46,12,12,0,0,12,1 (1ct 0st),0.26,
48,Usman Ghani (AFG),2015-2021,23,23,12,12,0,0,12,2 (2ct 0st),0.521,
49,Usman Patel (KUW),2020-2021,8,8,12,8,4,8,0,4 (4ct 0st),1.5,
0,HA Varaiya (KENYA),2007-2013,25,25,12,12,0,0,12,2 (2ct 0st),0.48,
1,Younis Khan (PAK),2006-2010,25,25,12,12,0,0,12,2 (2ct 0st),0.48,
2,Yuvraj Singh (INDIA),2007-2017,57,57,12,12,0,0,12,2 (2ct 0st),0.21,
3,Sarfraz Butt (Saudi),2020-2021,7,7,12,5,7,5,0,3 (0ct 3st),1.714,
4,S Adedeji (NGA),2019-2021,24,24,11,11,0,0,11,2 (2ct 0st),0.458,
5,A Bagai (CAN),2008-2013,9,9,11,5,6,5,0,2 (1ct 1st),1.222,
6,S Bau (PNG),2016-2021,27,27,11,11,0,0,11,3 (3ct 0st),0.407,
7,N Davin (NAM),2019-2019,16,16,11,11,0,0,11,3 (3ct 0st),0.687,
8,R Escobar (Arg),2019-2021,11,11,11,8,3,8,0,3 (3ct 0st),1.0,
9,JP Faulkner (AUS),2012-2017,24,24,11,11,0,0,11,2 (2ct 0st),0.458,
10,G Gambhir (INDIA),2007-2012,36,36,11,11,0,0,11,2 (2ct 0st),0.305,
11,Haris Rauf (PAK),2020-2021,31,31,11,11,0,0,11,2 (2ct 0st),0.354,
12,Imran Nazir (PAK),2007-2012,25,25,11,11,0,0,11,2 (2ct 0st),0.44,
13,FJ Klaassen (NED),2018-2021,23,23,11,11,0,0,11,2 (2ct 0st),0.478,
14,TWM Latham (NZ),2012-2021,16,16,11,8,3,6,2,3 (3ct 0st),0.687,
15,PL Mommsen (SCOT),2012-2016,22,22,11,11,0,0,11,2 (2ct 0st),0.5,
16,JF Mooney (IRE),2009-2015,26,26,11,11,0,0,11,2 (2ct 0st),0.423,
17,Rizwan Cheema (CAN),2008-2019,23,23,11,11,0,0,11,2 (2ct 0st),0.478,
18,KD Shah (HKG),2014-2020,35,35,11,11,0,0,11,3 (3ct 0st),0.314,
19,Shaiman Anwar (UAE),2014-2019,31,31,11,11,0,0,11,2 (2ct 0st),0.354,
20,T Shamsi (SA),2017-2021,47,47,11,11,0,0,11,2 (2ct 0st),0.234,
21,SM Sharif (SCOT),2012-2021,52,52,11,11,0,0,11,2 (2ct 0st),0.211,
22,Simi Singh (IRE),2018-2021,38,38,11,11,0,0,11,2 (2ct 0st),0.289,
23,T Taibu (ZIM),2007-2012,17,17,11,6,5,6,0,3 (0ct 3st),0.647,
24,JK Theodore (Ghana),2021-2021,11,11,11,7,4,7,0,2 (2ct 0st),1.0,
25,D Weston (GER),2019-2019,6,6,11,9,2,9,0,4 (3ct 1st),1.833,
26,SA Yadav (INDIA),2021-2021,11,11,11,11,0,0,11,2 (2ct 0st),1.0,
27,Zaheer Ibrahim (QAT),2019-2021,24,24,11,11,0,0,11,3 (3ct 0st),0.458,
28,Abdur Razzak (BAN),2006-2014,33,33,10,10,0,0,10,2 (2ct 0st),0.303,
29,DS Airee (NEPAL),2019-2021,25,25,10,10,0,0,10,2 (2ct 0st),0.4,
30,Aizaz Khan (HKG),2014-2020,39,39,10,10,0,0,10,2 (2ct 0st),0.256,
31,SE Aquilina (MLT),2019-2021,15,15,10,4,6,4,0,2 (1ct 1st),0.666,
32,SJ Baard (NAM),2019-2021,22,22,10,10,0,0,10,2 (2ct 0st),0.454,
33,GJ Bailey (AUS/World),2012-2017,30,30,10,10,0,0,10,2 (2ct 0st),0.333,
34,SJ Benn (WI),2008-2016,24,24,10,10,0,0,10,3 (3ct 0st),0.416,
35,RD Berrington (SCOT),2008-2021,72,72,10,10,0,0,10,2 (2ct 0st),0.138,
36,TT Bresnan (ENG),2006-2014,33,33,10,10,0,0,10,2 (2ct 0st),0.303,
37,RW Chakabva (ZIM),2008-2021,26,26,10,10,0,6,4,2 (2ct 0st),0.384,
38,GJ Delany (IRE),2019-2021,28,28,10,10,0,0,10,2 (2ct 0st),0.357,
39,PWH de Silva (SL),2019-2021,32,32,10,10,0,0,10,2 (2ct 0st),0.312,
40,AC Evans (SCOT),2015-2021,32,32,10,10,0,0,10,2 (2ct 0st),0.312,
41,Hasan Ali (PAK),2016-2021,45,45,10,10,0,0,10,1 (1ct 0st),0.222,
42,Hilal Ahmad (CZK-R),2019-2021,15,15,10,8,2,7,1,3 (3ct 0st),0.666,
43,SD Hope (WI),2017-2022,17,17,10,9,1,8,1,2 (2ct 0st),0.588,
44,Karan KC (NEPAL),2015-2021,32,32,10,10,0,0,10,2 (2ct 0st),0.312,
45,BR McDermott (AUS),2018-2021,15,15,10,10,0,0,10,3 (3ct 0st),0.666,
46,Mashrafe Mortaza (BAN),2006-2017,53,53,10,10,0,0,10,3 (3ct 0st),0.188,
47,J Mees (LUX),2019-2021,16,16,10,9,1,6,3,2 (2ct 0st),0.625,
48,AK Mohan (Fin),2019-2021,9,9,10,8,2,3,5,3 (2ct 1st),1.111,
49,K Motlhanka (BOT),2019-2021,11,11,10,6,4,3,3,4 (2ct 2st),0.909,
0,JDS Neesham (NZ),2012-2021,37,37,10,10,0,0,10,2 (2ct 0st),0.27,
1,JL Ontong (SA),2008-2015,13,13,10,10,0,0,10,3 (3ct 0st),0.769,
2,Riazat Ali Shah (UGA),2019-2021,24,24,10,10,0,0,10,2 (2ct 0st),0.416,
3,Sompal Kami (NEPAL),2014-2021,32,32,10,10,0,0,10,2 (2ct 0st),0.312,
4,H Srinivasan (GER),2019-2021,8,8,10,6,4,6,0,2 (2ct 0st),1.25,
5,AJ Tye (AUS),2016-2021,31,31,10,10,0,0,10,2 (2ct 0st),0.322,
6,HE van der Dussen (SA),2018-2021,34,34,10,10,0,0,10,2 (2ct 0st),0.294,
7,Washington Sundar (INDIA),2017-2021,30,30,10,10,0,0,10,2 (2ct 0st),0.333,
8,D Wiese (NAM/SA),2013-2021,31,31,10,10,0,0,10,2 (2ct 0st),0.322,
9,Zeeshan Maqsood (OMA),2015-2021,33,33,10,10,0,0,10,2 (2ct 0st),0.303,
10,Afif Hossain (BAN),2018-2021,39,39,9,9,0,0,9,1 (1ct 0st),0.23,
11,R Ashwin (INDIA),2010-2021,50,50,9,9,0,0,9,1 (1ct 0st),0.18,
12,AJ Ayannaike (NGA),2019-2021,20,20,9,8,1,5,3,3 (2ct 1st),0.45,
13,KS Bagabena (Ghana),2019-2021,15,15,9,9,0,0,9,3 (3ct 0st),0.6,
14,T Banton (ENG),2019-2022,13,13,9,9,0,2,7,2 (2ct 0st),0.692,
15,T Bavuma (SA),2019-2021,21,21,9,9,0,0,9,3 (3ct 0st),0.428,
16,DG Blampied (JER),2019-2021,23,23,9,9,0,0,9,2 (2ct 0st),0.391,
17,Mudassar Bukhari (NED),2008-2016,36,36,9,9,0,0,9,2 (2ct 0st),0.25,
18,YS Chahal (INDIA),2016-2021,50,50,9,9,0,0,9,2 (2ct 0st),0.18,
19,CJ Chibhabha (ZIM),2006-2020,36,36,9,9,0,0,9,2 (2ct 0st),0.25,
20,FA Cossa (MOZ),2019-2021,9,9,9,9,0,0,9,3 (3ct 0st),1.0,
21,PJ Cummins (AUS),2011-2021,36,36,9,9,0,0,9,1 (1ct 0st),0.25,
22,JW Dernbach (ENG/ITA),2011-2021,38,38,9,9,0,0,9,2 (2ct 0st),0.236,
23,SS Iyer (INDIA),2017-2021,31,31,9,9,0,0,9,1 (1ct 0st),0.29,
24,Janak Prakash (SGP),2019-2020,15,15,9,9,0,0,9,3 (3ct 0st),0.6,
25,DT Johnston (IRE),2008-2013,27,27,9,9,0,0,9,3 (3ct 0st),0.333,
26,JP Kotze (NAM),2019-2021,15,15,9,7,2,2,5,3 (1ct 2st),0.6,
27,B Kumar (INDIA),2012-2021,53,53,9,9,0,0,9,1 (1ct 0st),0.169,
28,PD McGlashan (NZ),2006-2010,11,11,9,9,0,9,0,3 (3ct 0st),0.818,
29,Mohammad Nadeem (OMA),2015-2021,28,28,9,9,0,0,9,3 (3ct 0st),0.321,
30,J Mubarak (SL),2007-2009,16,16,9,9,0,0,9,2 (2ct 0st),0.562,
31,S Muniandy (MAL),2019-2021,27,27,9,9,0,0,9,3 (3ct 0st),0.333,
32,MK Pandey (INDIA),2015-2020,39,39,9,9,0,0,9,2 (2ct 0st),0.23,
33,YK Pathan (INDIA),2007-2012,22,22,9,9,0,0,9,2 (2ct 0st),0.409,
34,RJ Peterson (SA),2006-2014,20,20,9,9,0,0,9,2 (2ct 0st),0.45,
35,JA Richardson (AUS),2017-2021,14,14,9,9,0,0,9,2 (2ct 0st),0.642,
36,RR Rossouw (SA),2014-2016,15,15,9,9,0,0,9,3 (3ct 0st),0.6,
37,Saber Zakhil (Belg),2019-2021,15,15,9,9,0,0,9,2 (2ct 0st),0.6,
38,Sahir Naqash (GER),2019-2021,21,21,9,9,0,0,9,2 (2ct 0st),0.428,
39,CJO Smith (SCOT),2007-2009,7,7,9,5,4,5,0,2 (2ct 0st),1.285,
40,MC Sorensen (IRE),2012-2016,23,23,9,9,0,0,9,2 (2ct 0st),0.391,
41,Suraj Kumar (OMA),2019-2021,17,17,9,7,2,7,0,2 (2ct 0st),0.529,
42,JE Taylor (WI),2006-2018,30,30,9,9,0,0,9,1 (1ct 0st),0.3,
43,T van der Gugten (NED),2012-2021,39,39,9,9,0,0,9,2 (2ct 0st),0.23,
44,DL Vettori (NZ),2007-2014,34,34,9,9,0,0,9,2 (2ct 0st),0.264,
45,CD Wallace (SCOT),2012-2021,20,20,9,7,2,6,1,2 (2ct 0st),0.45,
46,MN Waller (ZIM),2011-2018,32,32,9,9,0,0,9,1 (1ct 0st),0.281,
47,A Zampa (AUS),2016-2021,55,55,9,9,0,0,9,2 (2ct 0st),0.163,
48,MR Adair (IRE),2019-2021,31,31,8,8,0,0,8,2 (2ct 0st),0.258,
49,CJA Amini (PNG),2015-2021,27,27,8,8,0,0,8,2 (2ct 0st),0.296,
0,Bilal Khan (OMA),2015-2021,37,37,8,8,0,0,8,2 (2ct 0st),0.216,
1,PVD Chameera (SL),2015-2021,39,39,8,8,0,0,8,2 (2ct 0st),0.205,
2,TK Curran (ENG),2017-2021,29,29,8,8,0,0,8,1 (1ct 0st),0.275,
3,S Dube (INDIA),2019-2020,12,12,8,8,0,0,8,2 (2ct 0st),0.666,
4,HH Gibbs (SA),2005-2010,23,23,8,8,0,0,8,3 (3ct 0st),0.347,
5,OD Hald (DEN),2019-2021,10,10,8,8,0,0,8,3 (3ct 0st),0.8,
6,D Kansonkho (MWI),2019-2021,12,12,8,8,0,0,8,2 (2ct 0st),0.666,
7,G Kansonkho (MWI),2019-2021,10,10,8,8,0,0,8,2 (2ct 0st),0.8,
8,Kuldeep Yadav (INDIA),2017-2021,21,21,8,8,0,0,8,2 (2ct 0st),0.38,
9,LS Livingstone (ENG),2017-2022,17,17,8,8,0,0,8,2 (2ct 0st),0.47,
10,Mahedi Hasan (BAN),2018-2021,29,29,8,8,0,0,8,2 (2ct 0st),0.275,
11,KD Mills (NZ),2005-2014,41,41,8,8,0,0,8,1 (1ct 0st),0.195,
12,M Mosehle (SA),2017-2017,7,7,8,6,2,6,0,3 (2ct 1st),1.142,
13,Nouman Sarwar (QAT),2019-2019,14,14,8,8,0,0,8,2 (2ct 0st),0.571,
14,NN Odhiambo (KENYA),2007-2021,34,34,8,8,0,0,8,1 (1ct 0st),0.235,
15,RN Patel (KENYA),2019-2021,14,14,8,8,0,0,8,2 (2ct 0st),0.571,
16,CW Perchard (JER),2019-2021,21,21,8,8,0,0,8,1 (1ct 0st),0.38,
17,RT Ponting (AUS),2005-2009,17,17,8,8,0,0,8,2 (2ct 0st),0.47,
18,MJ Prior (ENG),2007-2010,9,9,8,6,2,6,0,4 (4ct 0st),0.888,
19,Rameez Shahzad (UAE),2016-2019,21,21,8,8,0,0,8,2 (2ct 0st),0.38,
20,R Satheesan (ROM),2019-2021,17,17,8,8,0,0,8,2 (2ct 0st),0.47,
21,HAM Shah (DEN),2019-2021,10,10,8,8,0,0,8,3 (3ct 0st),0.8,
22,DJM Short (AUS),2018-2020,22,22,8,8,0,0,8,2 (2ct 0st),0.363,
23,DR Smith (WI),2006-2015,32,32,8,8,0,0,8,1 (1ct 0st),0.25,
24,SB Styris (NZ),2005-2010,31,31,8,8,0,0,8,2 (2ct 0st),0.258,
25,Syed Aziz (MAL),2019-2021,26,26,8,8,0,0,8,1 (1ct 0st),0.307,
26,RML Taylor (SCOT),2013-2016,9,9,8,8,0,0,8,2 (2ct 0st),0.888,
27,TP Ura (PNG),2015-2021,26,26,8,8,0,0,8,2 (2ct 0st),0.307,
28,N Vanua (PNG),2015-2021,30,30,8,8,0,0,8,2 (2ct 0st),0.266,
29,S Vashisht (ROM),2019-2021,12,12,8,8,0,0,8,2 (2ct 0st),0.666,
30,Waqas Barkat (HKG),2014-2020,30,30,8,8,0,0,8,2 (2ct 0st),0.266,
31,B Ward (JER),2019-2021,19,19,8,8,0,0,8,2 (2ct 0st),0.421,
32,MRJ Watt (SCOT),2015-2021,45,45,8,8,0,0,8,1 (1ct 0st),0.177,
33,KOK Williams (WI),2016-2020,25,25,8,8,0,0,8,1 (1ct 0st),0.32,
34,MH Yardy (ENG),2006-2011,13,13,8,8,0,0,8,2 (2ct 0st),0.615,
35,Yasir Ali (ESP),2019-2021,14,14,8,8,0,0,8,2 (2ct 0st),0.571,
36,CA Young (IRE),2015-2021,40,40,8,8,0,0,8,2 (2ct 0st),0.2,
37,KJ Abbott (SA),2013-2016,21,21,7,7,0,0,7,2 (2ct 0st),0.333,
38,RG Aga (KENYA),2008-2013,20,20,7,7,0,0,7,2 (2ct 0st),0.35,
39,Anique Uddin (DEN),2019-2021,10,10,7,7,0,0,7,3 (3ct 0st),0.7,
40,Aqib Ilyas (OMA),2015-2021,25,25,7,7,0,0,7,2 (2ct 0st),0.28,
41,MNM Aslam (KUW),2019-2021,15,15,7,7,0,0,7,1 (1ct 0st),0.466,
42,S Badree (WI/World),2012-2018,50,50,7,7,0,0,7,2 (2ct 0st),0.14,
43,HS Baidwan (CAN),2008-2013,17,17,7,7,0,0,7,2 (2ct 0st),0.411,
44,Meet Bhavsar (KUW),2019-2021,13,13,7,7,0,5,2,3 (3ct 0st),0.538,
45,Bilal Tahir (KUW),2019-2021,11,11,7,7,0,0,7,1 (1ct 0st),0.636,
46,AC Botha (IRE),2008-2010,12,12,7,7,0,0,7,2 (2ct 0st),0.583,
47,DAJ Bracewell (NZ),2011-2021,19,19,7,7,0,0,7,2 (2ct 0st),0.368,
48,JJ Bumrah (INDIA),2016-2021,52,52,7,7,0,0,7,2 (2ct 0st),0.134,
49,S Chanderpaul (WI),2006-2010,22,22,7,7,0,0,7,1 (1ct 0st),0.318,
0,AR Cusack (IRE),2008-2015,32,32,7,7,0,0,7,2 (2ct 0st),0.218,
1,A Dananjaya (SL),2012-2021,30,30,7,7,0,0,7,1 (1ct 0st),0.233,
2,Dawlat Zadran (AFG),2012-2019,34,34,7,7,0,0,7,2 (2ct 0st),0.205,
3,NS Dhaliwal (CAN),2019-2021,17,17,7,7,0,0,7,1 (1ct 0st),0.411,
4,AC Douglas (BMUDA),2019-2021,15,15,7,7,0,0,7,3 (3ct 0st),0.466,
5,BR Dunk (AUS),2014-2017,5,5,7,5,2,4,1,3 (1ct 2st),1.4,
6,L Emilio (MOZ),2019-2021,8,8,7,4,3,2,2,3 (1ct 2st),0.875,
7,Fawad Alam (PAK),2007-2010,24,24,7,7,0,0,7,2 (2ct 0st),0.291,
8,WIA Fernando (SL),2019-2021,29,29,7,7,0,0,7,2 (2ct 0st),0.241,
9,Fiaz Ahmed (BHR),2019-2021,10,10,7,7,0,0,7,2 (2ct 0st),0.7,
10,S Gajjar (CZK-R),2020-2020,3,3,7,4,3,3,1,3 (2ct 1st),2.333,
11,Harbhajan Singh (INDIA),2006-2016,27,27,7,7,0,0,7,2 (2ct 0st),0.259,
12,AW Hawkins-Kay (JER),2019-2019,16,16,7,7,0,0,7,2 (2ct 0st),0.437,
13,Iftikhar Ahmed (PAK),2016-2021,15,15,7,7,0,0,7,1 (1ct 0st),0.466,
14,Imran Ali Butt (BHR),2019-2021,12,12,7,4,3,4,0,2 (2ct 0st),0.583,
15,Imran Tahir (SA/World),2013-2019,38,38,7,7,0,0,7,2 (2ct 0st),0.184,
16,S Jamil (Belg),2019-2021,9,9,7,7,0,6,1,2 (2ct 0st),0.777,
17,JH Kallis (SA),2005-2012,24,24,7,7,0,0,7,2 (2ct 0st),0.291,
18,BA King (WI),2019-2022,18,18,7,7,0,0,7,2 (2ct 0st),0.388,
19,EB Knowles (CZK-R),2019-2021,14,14,7,7,0,3,4,4 (4ct 0st),0.5,
20,MJ Lumb (ENG),2010-2014,25,25,7,7,0,0,7,1 (1ct 0st),0.28,
21,MJ McClenaghan (ICC/NZ),2012-2018,28,28,7,7,0,0,7,1 (1ct 0st),0.25,
22,MW Machan (SCOT),2013-2016,13,13,7,7,0,0,7,1 (1ct 0st),0.538,
23,W Madhevere (ZIM),2020-2021,21,21,7,7,0,0,7,2 (2ct 0st),0.333,
24,A Manepalli (LUX),2020-2021,6,6,7,7,0,7,0,3 (3ct 0st),1.166,
25,AD Mascarenhas (ENG),2007-2009,14,14,7,7,0,0,7,2 (2ct 0st),0.5,
26,Mehidy Hasan Miraz (BAN),2017-2018,13,13,7,7,0,0,7,2 (2ct 0st),0.538,
27,BMAJ Mendis (SL),2011-2018,21,21,7,7,0,0,7,2 (2ct 0st),0.333,
28,Mohammad Saifuddin (BAN),2017-2021,29,29,7,7,0,0,7,2 (2ct 0st),0.241,
29,Mohammed Nadeem (QAT),2019-2021,26,26,7,7,0,0,7,2 (2ct 0st),0.269,
30,PJ Moor (ZIM),2016-2019,21,21,7,7,0,2,5,2 (2ct 0st),0.333,
31,Mosaddek Hossain (BAN),2016-2021,16,16,7,7,0,0,7,2 (2ct 0st),0.437,
32,Muhammad Tanveer (QAT),2019-2021,26,26,7,7,0,0,7,2 (2ct 0st),0.269,
33,C Munoz-Mills (ESP),2019-2021,14,14,7,7,0,0,7,2 (2ct 0st),0.5,
34,SP Narine (WI),2012-2019,48,48,7,7,0,0,7,2 (2ct 0st),0.145,
35,D Nikolov (BUL),2019-2021,14,14,7,7,0,0,7,2 (2ct 0st),0.5,
36,H Osinde (CAN),2008-2013,11,11,7,7,0,0,7,2 (2ct 0st),0.636,
37,R Panchal (ESP),2019-2021,14,14,7,7,0,0,7,2 (2ct 0st),0.5,
38,AR Patwa (TAN),2021-2021,10,10,7,7,0,0,7,2 (2ct 0st),0.7,
39,AL Phehlukwayo (SA),2017-2021,35,35,7,7,0,0,7,2 (2ct 0st),0.2,
40,LE Plunkett (ENG),2006-2019,22,22,7,7,0,0,7,1 (1ct 0st),0.318,
41,Rahmanullah Gurbaz (AFG),2019-2021,18,18,7,6,1,6,0,2 (2ct 0st),0.388,
42,JD Ryder (NZ),2008-2014,22,22,7,7,0,0,7,2 (2ct 0st),0.318,
43,Sajid Cheema (Saudi),2019-2021,11,11,7,7,0,0,7,2 (2ct 0st),0.636,
44,Sandeep Goud (OMA),2019-2021,18,18,7,7,0,0,7,2 (2ct 0st),0.388,
45,P Sarraf (NEPAL),2019-2020,12,12,7,7,0,0,7,4 (4ct 0st),0.583,
46,RR Sarwan (WI),2007-2010,18,18,7,7,0,0,7,1 (1ct 0st),0.388,
47,Shaheen Shah Afridi (PAK),2018-2021,37,37,7,7,0,0,7,3 (3ct 0st),0.189,
48,Shiraz Khan (KUW),2019-2021,15,15,7,7,0,0,7,2 (2ct 0st),0.466,
49,P Silas (BOT),2019-2021,8,8,7,7,0,0,7,3 (3ct 0st),0.875,
0,Sohaib Maqsood (PAK),2013-2021,24,24,7,7,0,0,7,2 (2ct 0st),0.291,
1,Sohail Tanvir (PAK),2007-2017,57,57,7,7,0,0,7,1 (1ct 0st),0.122,
2,MR Swart (NED),2012-2016,26,26,7,7,0,0,7,1 (1ct 0st),0.269,
3,R Tari (VAN),2019-2019,14,14,7,7,0,0,7,2 (2ct 0st),0.5,
4,SR Taylor (USA),2019-2021,13,13,7,7,0,0,7,2 (2ct 0st),0.538,
5,HDRL Thirimanne (SL),2012-2016,25,25,7,7,0,0,7,1 (1ct 0st),0.28,
6,JM Vince (ENG),2015-2022,17,17,7,7,0,0,7,2 (2ct 0st),0.411,
7,HR Walsh (USA/WI),2019-2021,24,24,7,7,0,0,7,2 (2ct 0st),0.291,
8,KJ Young (Blz),2019-2021,9,9,7,7,0,4,3,2 (2ct 0st),0.777,
9,Yusuf Ebrahim (PNM),2019-2021,9,9,7,7,0,0,7,2 (2ct 0st),0.777,
10,Abdul-Shakoor Rahimzei (GER),2019-2021,17,17,6,6,0,0,6,2 (2ct 0st),0.352,
11,Abdul Shakoor (ROM),2019-2021,8,8,6,4,2,2,2,2 (1ct 1st),0.75,
12,Abdur Rehman (PAK),2007-2013,8,8,6,6,0,0,6,2 (2ct 0st),0.75,
13,Adnan Idrees (KUW),2019-2021,10,10,6,6,0,0,6,1 (1ct 0st),0.6,
14,PS Airee (NEPAL),2015-2019,11,11,6,5,1,3,2,2 (2ct 0st),0.545,
15,Amar Sharma (MLT),2020-2021,19,19,6,6,0,0,6,1 (1ct 0st),0.315,
16,Anshuman Rath (HKG),2015-2017,20,20,6,6,0,0,6,1 (1ct 0st),0.3,
17,V Aravind (UAE),2020-2021,9,9,6,5,1,5,0,3 (3ct 0st),0.666,
18,A Ashokan (CZK-R),2019-2021,13,13,6,6,0,0,6,2 (2ct 0st),0.461,
19,V Balakrishnan (BOT),2019-2021,7,7,6,6,0,0,6,3 (3ct 0st),0.857,
20,J Bangura (SLE),2021-2021,10,10,6,5,1,5,0,2 (2ct 0st),0.6,
21,J Barker (LUX),2019-2021,13,13,6,6,0,0,6,2 (2ct 0st),0.461,
22,JP Behrendorff (AUS),2017-2021,8,8,6,6,0,0,6,3 (3ct 0st),0.75,
23,M Bhanuka (SL),2019-2021,5,5,6,6,0,6,0,2 (2ct 0st),1.2,
24,A Bohara (NEPAL),2019-2021,24,24,6,6,0,0,6,1 (1ct 0st),0.25,
25,RS Bopara (ENG),2008-2014,36,36,6,6,0,0,6,2 (2ct 0st),0.166,
26,W Boshoff (SWE),2021-2021,7,7,6,6,0,5,1,2 (2ct 0st),0.857,
27,NW Bracken (AUS),2006-2009,19,19,6,6,0,0,6,1 (1ct 0st),0.315,
28,DT Christian (AUS),2010-2021,23,23,6,6,0,0,6,2 (2ct 0st),0.26,
29,TLW Cooper (NED),2012-2016,17,17,6,6,0,0,6,2 (2ct 0st),0.352,
30,M Cope (LUX),2019-2021,10,10,6,6,0,0,6,2 (2ct 0st),0.6,
31,AG Cremer (ZIM),2008-2018,29,29,6,6,0,0,6,1 (1ct 0st),0.206,
32,BFW de Leede (NED),2018-2021,16,16,6,6,0,0,6,3 (3ct 0st),0.375,
33,DM de Silva (SL),2015-2021,22,22,6,6,0,0,6,1 (1ct 0st),0.272,
34,Ehsan Khan (HKG),2016-2020,23,23,6,6,0,0,6,1 (1ct 0st),0.26,
35,LB Ferbrache (GUE),2019-2020,9,9,6,6,0,0,6,2 (2ct 0st),0.666,
36,ST Finn (ENG),2011-2015,20,20,6,6,0,0,6,1 (1ct 0st),0.3,
37,JS Foster (ENG),2009-2009,5,5,6,3,3,3,0,2 (1ct 1st),1.2,
38,GC Galanis (GRC),2019-2021,5,5,6,6,0,0,6,2 (2ct 0st),1.2,
39,HS Gericke (MLT),2020-2021,11,11,6,6,0,6,0,2 (2ct 0st),0.545,
40,SC Getkate (IRE),2019-2021,25,25,6,6,0,0,6,2 (2ct 0st),0.24,
41,C Hartmann (IOM),2020-2021,5,5,6,5,1,5,0,2 (2ct 0st),1.2,
42,MC Henriques (AUS),2009-2021,24,24,6,6,0,0,6,1 (1ct 0st),0.25,
43,GJ Hopkins (NZ),2007-2010,10,10,6,4,2,2,2,2 (2ct 0st),0.6,
44,Ibrahim Rizan (Mald),2019-2021,12,12,6,6,0,0,6,3 (3ct 0st),0.5,
45,Imran Haider (ROM),2019-2021,4,4,6,4,2,4,0,3 (2ct 1st),1.5,
46,Imran Ismail (MOZ),2019-2019,6,6,6,6,0,5,1,2 (2ct 0st),1.0,
47,H Ivanov (BUL),2019-2021,11,11,6,6,0,5,1,2 (2ct 0st),0.545,
48,Kamran Khan (QAT),2019-2021,25,25,6,6,0,0,6,2 (2ct 0st),0.24,
49,Karim Janat (AFG),2016-2021,32,32,6,6,0,0,6,2 (2ct 0st),0.187,
0,Karim Sadiq (AFG),2010-2018,36,36,6,6,0,0,6,1 (1ct 0st),0.166,
1,SC Kuggeleijn (NZ),2019-2021,17,17,6,6,0,0,6,2 (2ct 0st),0.352,
2,ND Laegsgaard (DEN),2019-2019,7,7,6,6,0,0,6,3 (3ct 0st),0.857,
3,B Lee (AUS),2005-2012,24,24,6,6,0,0,6,3 (3ct 0st),0.25,
4,GF Linde (SA),2020-2021,14,14,6,6,0,0,6,3 (3ct 0st),0.428,
5,JB Little (IRE),2016-2021,26,26,6,6,0,0,6,2 (2ct 0st),0.23,
6,AR McBrine (IRE),2014-2021,18,18,6,6,0,0,6,2 (2ct 0st),0.333,
7,JS Malhotra (USA),2019-2021,11,11,6,3,3,2,1,2 (0ct 2st),0.545,
8,N Mapunda (TAN),2021-2021,7,7,6,3,3,3,0,2 (2ct 0st),0.857,
9,PK Matautaava (VAN),2019-2019,10,10,6,6,0,0,6,3 (3ct 0st),0.6,
10,V Mbazo (BOT),2019-2021,8,8,6,4,2,4,0,2 (2ct 0st),0.75,
11,GP Meade (ITA),2019-2021,13,13,6,6,0,0,6,1 (1ct 0st),0.461,
12,NSK Mehta (Belg),2020-2021,9,9,6,6,0,0,6,2 (2ct 0st),0.666,
13,BAW Mendis (SL),2008-2014,39,39,6,6,0,0,6,1 (1ct 0st),0.153,
14,BKG Mendis (SL),2016-2021,29,29,6,6,0,0,6,1 (1ct 0st),0.206,
15,AF Milne (NZ),2010-2021,31,31,6,6,0,0,6,1 (1ct 0st),0.193,
16,Mohamed Rishwan (Mald),2019-2021,17,17,6,6,0,0,6,2 (2ct 0st),0.352,
17,SR Mohan (SEY),2021-2021,6,6,6,3,3,3,0,2 (0ct 2st),1.0,
18,CH Morris (SA),2012-2019,23,23,6,6,0,0,6,2 (2ct 0st),0.26,
19,TK Musakanda (ZIM),2018-2021,12,12,6,6,0,0,6,2 (2ct 0st),0.5,
20,Nasir Jamshed (PAK),2012-2013,18,18,6,6,0,0,6,2 (2ct 0st),0.333,
21,Naveed Ahmed (CZK-R),2019-2021,17,17,6,6,0,0,6,2 (2ct 0st),0.352,
22,K Nestor (GIBR),2019-2021,13,13,6,6,0,0,6,1 (1ct 0st),0.461,
23,AR Nurse (WI),2011-2019,12,12,6,6,0,0,6,2 (2ct 0st),0.5,
24,CN Onwuzulike (NGA),2019-2021,15,15,6,6,0,0,6,3 (3ct 0st),0.4,
25,KH Pandya (INDIA),2018-2021,18,18,6,6,0,0,6,2 (2ct 0st),0.333,
26,HH Patel (MWI),2019-2019,6,6,6,6,0,0,6,2 (2ct 0st),1.0,
27,NK Patel (USA),2019-2021,12,12,6,6,0,0,6,2 (2ct 0st),0.5,
28,BBJL Perera (ITA),2019-2021,13,13,6,6,0,0,6,3 (3ct 0st),0.461,
29,N Pokana (PNG),2016-2021,22,22,6,6,0,0,6,2 (2ct 0st),0.272,
30,Aminuddin Ramly (MAL),2019-2021,22,22,6,6,0,0,6,2 (2ct 0st),0.272,
31,D Ravu (PNG),2019-2021,19,19,6,6,0,0,6,1 (1ct 0st),0.315,
32,Rehman Abdul (ITA),2019-2019,6,6,6,6,0,0,6,2 (2ct 0st),1.0,
33,V Saini (ROM),2020-2021,12,12,6,6,0,0,6,2 (2ct 0st),0.5,
34,S Samarawickrama (SL),2017-2021,9,9,6,4,2,3,1,2 (1ct 1st),0.666,
35,Sami Sohail (MWI),2019-2021,12,12,6,6,0,0,6,2 (2ct 0st),0.5,
36,SV Samson (INDIA),2015-2021,10,10,6,4,2,0,4,1 (1ct 0st),0.6,
37,PADLR Sandakan (SL),2017-2021,20,20,6,6,0,0,6,2 (2ct 0st),0.3,
38,Shahid Wasif (HKG),2016-2020,18,18,6,6,0,0,6,2 (2ct 0st),0.333,
39,Sharjeel Khan (PAK),2013-2021,18,18,6,6,0,0,6,2 (2ct 0st),0.333,
40,TAM Siriwardana (SL),2015-2017,22,22,6,6,0,0,6,2 (2ct 0st),0.272,
41,DC Stovell (BMUDA),2019-2021,12,12,6,6,0,0,6,1 (1ct 0st),0.5,
42,SN Thakur (INDIA),2018-2021,23,23,6,6,0,0,6,1 (1ct 0st),0.26,
43,AJ Turner (AUS),2017-2021,17,17,6,6,0,0,6,1 (1ct 0st),0.352,
44,P Utseya (ZIM),2006-2015,35,35,6,6,0,0,6,1 (1ct 0st),0.171,
45,MN van Wyk (SA),2007-2015,8,8,6,5,1,3,2,1 (1ct 0st),0.75,
46,JNT Vare (PNG),2015-2017,8,8,6,4,2,4,0,3 (3ct 0st),0.75,
47,S Vesawkar (NEPAL),2014-2019,16,16,6,6,0,0,6,1 (1ct 0st),0.375,
48,Wahab Riaz (PAK),2008-2020,35,35,6,6,0,0,6,1 (1ct 0st),0.171,
49,Waseem Abbas (MLT),2019-2021,22,22,6,6,0,0,6,2 (2ct 0st),0.272,
0,DF Watts (SCOT),2007-2012,10,10,6,6,0,0,6,3 (3ct 0st),0.6,
1,Aarif Sheikh (NEPAL),2019-2021,14,14,5,5,0,0,5,1 (1ct 0st),0.357,
2,Abrar Bilal (Aut),2019-2021,7,7,5,2,3,2,0,1 (1ct 0st),0.714,
3,Adnan Ilyas (OMA),2015-2016,11,11,5,5,0,0,5,3 (3ct 0st),0.454,
4,KK Ahuja (Mex),2019-2019,8,8,5,2,3,1,1,2 (0ct 2st),0.625,
5,CM Akachukwu (NGA),2019-2021,15,15,5,5,0,0,5,2 (2ct 0st),0.333,
6,Anwar Ali (PAK),2008-2016,16,16,5,5,0,0,5,2 (2ct 0st),0.312,
7,Ariful Haque (BAN),2018-2018,9,9,5,5,0,0,5,1 (1ct 0st),0.555,
8,Asad Mohammad (GER),2019-2021,11,11,5,5,0,0,5,1 (1ct 0st),0.454,
9,MA Baig (MWI),2019-2021,12,12,5,5,0,0,5,3 (3ct 0st),0.416,
10,GG Banner (Blz),2019-2021,9,9,5,5,0,0,5,2 (2ct 0st),0.555,
11,P Baron (Arg),2019-2021,11,11,5,5,0,0,5,2 (2ct 0st),0.454,
12,Basil Hameed (UAE),2020-2021,8,8,5,5,0,0,5,2 (2ct 0st),0.625,
13,SVE Bharathi (GER),2020-2021,15,15,5,5,0,0,5,2 (2ct 0st),0.333,
14,DM Bravo (WI),2010-2022,25,25,5,5,0,0,5,2 (2ct 0st),0.2,
15,S Browne (LUX),2020-2020,4,4,5,5,0,0,5,2 (2ct 0st),1.25,
16,PKD Chase (IRE),2018-2019,12,12,5,5,0,0,5,2 (2ct 0st),0.416,
17,TL Chatara (ZIM),2010-2021,30,30,5,5,0,0,5,1 (1ct 0st),0.166,
18,LA Collado (GIBR),2019-2021,9,9,5,2,3,2,0,2 (0ct 2st),0.555,
19,BCJ Cutting (AUS/World),2013-2017,7,7,5,5,0,0,5,3 (3ct 0st),0.714,
20,KC D'Souza (BUL),2020-2021,17,17,5,5,0,0,5,1 (1ct 0st),0.294,
21,MD Dai (PNG),2015-2017,9,9,5,5,0,0,5,2 (2ct 0st),0.555,
22,K Dasan (BUL),2019-2020,9,9,5,3,2,2,1,2 (1ct 1st),0.555,
23,FH Edwards (WI),2007-2021,25,25,5,5,0,0,5,1 (1ct 0st),0.2,
24,Fahad Ali (),2019-2019,3,3,5,4,1,2,2,3 (2ct 1st),1.666,
25,Faisal Javed (QAT),2019-2019,15,15,5,5,0,0,5,1 (1ct 0st),0.333,
26,Fitri Sham (MAL),2019-2021,23,23,5,5,0,0,5,1 (1ct 0st),0.217,
27,JA Fitzgerald (GIBR),2019-2021,12,12,5,5,0,0,5,1 (1ct 0st),0.416,
28,A Flintoff (ENG),2005-2007,7,7,5,5,0,0,5,2 (2ct 0st),0.714,
29,PF Gallagher (Fin),2019-2021,7,7,5,5,0,0,5,2 (2ct 0st),0.714,
30,DM Gondaria (KENYA),2013-2019,11,11,5,5,0,0,5,1 (1ct 0st),0.454,
31,NA Greenwood (JER),2019-2019,8,8,5,5,0,0,5,3 (3ct 0st),0.625,
32,DAS Gunaratne (SL),2016-2017,12,12,5,5,0,0,5,2 (2ct 0st),0.416,
33,S Hallett (Peru),2019-2019,4,4,5,4,1,4,0,3 (3ct 0st),1.25,
34,Hamza Tahir (SCOT),2018-2021,13,13,5,5,0,0,5,1 (1ct 0st),0.384,
35,BJ Hodge (AUS),2007-2014,15,15,5,5,0,0,5,1 (1ct 0st),0.333,
36,Hussain Talat (PAK),2018-2021,18,18,5,5,0,0,5,3 (3ct 0st),0.277,
37,Jagjit Singh (Peru),2019-2019,4,4,5,5,0,0,5,3 (3ct 0st),1.25,
38,KM Jarvis (ZIM),2011-2019,22,22,5,5,0,0,5,1 (1ct 0st),0.227,
39,MG Johnson (AUS),2007-2013,29,29,5,5,0,0,5,1 (1ct 0st),0.172,
40,LM Jongwe (ZIM),2015-2021,22,22,5,5,0,0,5,2 (2ct 0st),0.227,
41,EC Joyce (ENG/IRE),2006-2014,17,17,5,5,0,0,5,2 (2ct 0st),0.294,
42,Junaid Sheikh (NOR),2019-2019,5,5,5,5,0,0,5,2 (2ct 0st),1.0,
43,A Kansonkho (MWI),2021-2021,6,6,5,5,0,0,5,3 (3ct 0st),0.833,
44,AL Kerai (SLE),2021-2021,9,9,5,5,0,0,5,3 (3ct 0st),0.555,
45,SP Khakurel (NEPAL),2014-2015,8,8,5,2,3,2,0,2 (0ct 2st),0.625,
46,UT Khawaja (AUS),2016-2016,9,9,5,5,0,0,5,1 (1ct 0st),0.555,
47,A Kirschbaum (Arg),2021-2021,6,6,5,5,0,0,5,2 (2ct 0st),0.833,
48,M Kpaka (SLE),2021-2021,7,7,5,5,0,0,5,2 (2ct 0st),0.714,
49,HG Kuhn (SA),2009-2017,7,7,5,5,0,4,1,3 (3ct 0st),0.714,
0,NR Kumar (CAN),2012-2019,17,17,5,5,0,0,5,2 (2ct 0st),0.294,
1,H Lakov (BUL),2019-2021,16,16,5,5,0,0,5,1 (1ct 0st),0.312,
2,AV Lalcheta (OMA),2015-2019,16,16,5,5,0,0,5,2 (2ct 0st),0.312,
3,S Lamichhane (ICC/NEPAL),2018-2021,25,25,5,5,0,0,5,1 (1ct 0st),0.2,
4,KS Leverock (BMUDA),2019-2021,17,17,5,5,0,0,5,1 (1ct 0st),0.294,
5,KA Maharaj (SA),2021-2021,8,8,5,5,0,0,5,2 (2ct 0st),0.625,
6,A Mansale (VAN),2019-2019,14,14,5,5,0,0,5,2 (2ct 0st),0.357,
7,XM Marshall (USA/WI),2008-2021,19,19,5,5,0,0,5,1 (1ct 0st),0.263,
8,T Maruma (ZIM),2008-2019,13,13,5,5,0,0,5,1 (1ct 0st),0.384,
9,S Matsikenyeri (ZIM),2006-2012,10,10,5,5,0,0,5,2 (2ct 0st),0.5,
10,EJB Miles (JER),2019-2021,17,17,5,5,0,0,5,2 (2ct 0st),0.294,
11,Mirwais Ashraf (AFG),2010-2016,25,25,5,5,0,0,5,1 (1ct 0st),0.2,
12,CB Mpofu (ZIM),2008-2020,32,32,5,5,0,0,5,2 (2ct 0st),0.156,
13,Murid Ekrami (Belg),2019-2021,11,11,5,5,0,0,5,2 (2ct 0st),0.454,
14,SJ Myburgh (NED),2012-2021,34,34,5,5,0,0,5,1 (1ct 0st),0.147,
15,A Natubhai Ahir (PNM),2019-2021,8,8,5,4,1,3,1,2 (1ct 1st),0.625,
16,R Nehonde (BOT),2019-2021,11,11,5,5,0,0,5,3 (3ct 0st),0.454,
17,RJ Nicol (NZ),2010-2013,20,20,5,5,0,0,5,2 (2ct 0st),0.25,
18,F Nsubuga (UGA),2019-2021,20,20,5,5,0,0,5,1 (1ct 0st),0.25,
19,AA Obanda (KENYA),2007-2021,41,41,5,5,0,0,5,1 (1ct 0st),0.121,
20,NM Odhiambo (KENYA),2010-2021,22,22,5,5,0,0,5,2 (2ct 0st),0.227,
21,TM Odoyo (KENYA),2007-2013,11,11,5,5,0,0,5,2 (2ct 0st),0.454,
22,WD Parnell (SA),2009-2017,40,40,5,5,0,0,5,1 (1ct 0st),0.125,
23,AR Patel (INDIA),2015-2021,15,15,5,5,0,0,5,2 (2ct 0st),0.333,
24,Pavandeep Singh (MAL),2019-2021,22,22,5,5,0,0,5,2 (2ct 0st),0.227,
25,T Perera (BOT),2019-2021,10,10,5,5,0,0,5,2 (2ct 0st),0.5,
26,J Rasu (VAN),2019-2019,13,13,5,5,0,0,5,1 (1ct 0st),0.384,
27,R Rohan (SGP),2019-2020,13,13,5,5,0,0,5,1 (1ct 0st),0.384,
28,Saad Bin Zafar (CAN),2019-2021,16,16,5,5,0,0,5,2 (2ct 0st),0.312,
29,Bilal Safdar (NOR),2021-2021,5,5,5,5,0,0,5,2 (2ct 0st),1.0,
30,Saud Islam (UGA),2021-2021,19,19,5,5,0,0,5,2 (2ct 0st),0.263,
31,E Schiferli (NED),2008-2010,6,6,5,5,0,0,5,1 (1ct 0st),0.833,
32,BM Scholtz (NAM),2019-2021,27,27,5,5,0,0,5,1 (1ct 0st),0.185,
33,S Ssesazi (UGA),2021-2021,16,16,5,5,0,0,5,2 (2ct 0st),0.312,
34,Shafiq Sharif (MAL),2019-2021,12,12,5,2,3,2,0,2 (2ct 0st),0.416,
35,Shafraz Jaleel (Mald),2019-2019,3,3,5,4,1,4,0,3 (3ct 0st),1.666,
36,OA Shah (ENG),2007-2009,16,16,5,5,0,0,5,2 (2ct 0st),0.312,
37,Shamim Hossain (BAN),2021-2021,10,10,5,5,0,0,5,2 (2ct 0st),0.5,
38,Shapoor Zadran (AFG),2010-2020,36,36,5,5,0,0,5,1 (1ct 0st),0.138,
39,Shoriful Islam (BAN),2021-2021,17,17,5,5,0,0,5,1 (1ct 0st),0.294,
40,M Shumba (ZIM),2020-2021,12,12,5,5,0,0,5,1 (1ct 0st),0.416,
41,RJ Sidebottom (ENG),2007-2010,16,16,5,5,0,0,5,2 (2ct 0st),0.312,
42,LPC Silva (SL),2006-2011,16,16,5,5,0,0,5,1 (1ct 0st),0.312,
43,TB Sole (SCOT),2019-2019,9,9,5,5,0,0,5,1 (1ct 0st),0.555,
44,I Tchakou (CAM),2021-2021,4,4,5,5,0,0,5,2 (2ct 0st),1.25,
45,VP Thamotharam (MLT),2020-2021,20,20,5,5,0,0,5,1 (1ct 0st),0.25,
46,SO Tikolo (KENYA),2007-2013,15,15,5,5,0,0,5,2 (2ct 0st),0.333,
47,CF Tlali (LES),2021-2021,6,6,5,5,0,5,0,3 (3ct 0st),0.833,
48,O Tuyisenge (RWN),2021-2021,11,11,5,5,0,0,5,2 (2ct 0st),0.454,
49,C Viljoen (NAM),2019-2019,12,12,5,5,0,0,5,1 (1ct 0st),0.416,
0,TP Visee (NED),2015-2021,30,30,5,5,0,0,5,1 (1ct 0st),0.166,
1,BTJ Wheal (SCOT),2016-2021,14,14,5,5,0,0,5,2 (2ct 0st),0.357,
2,CR Woakes (ENG),2011-2021,16,16,5,5,0,0,5,3 (3ct 0st),0.312,
3,Yusuf Bhoola (PNM),2021-2021,5,5,5,5,0,0,5,2 (2ct 0st),1.0,
4,SA Abbott (AUS),2014-2020,7,7,4,4,0,0,4,2 (2ct 0st),0.571,
5,CN Ackermann (NED),2019-2021,14,14,4,4,0,0,4,1 (1ct 0st),0.285,
6,Abdul Hashmi (DEN),2019-2021,8,8,4,1,3,1,0,1 (1ct 0st),0.5,
7,Aftab Ahmed (BAN),2006-2010,11,11,4,4,0,0,4,2 (2ct 0st),0.363,
8,SA Ahmad (DEN),2019-2021,9,9,4,4,0,0,4,1 (1ct 0st),0.444,
9,Ahmed Faiz (MAL),2019-2021,21,21,4,4,0,0,4,2 (2ct 0st),0.19,
10,Al-Amin Hossain (BAN),2013-2020,29,29,4,4,0,0,4,1 (1ct 0st),0.137,
11,Amjad Javed (UAE),2014-2017,22,22,4,4,0,0,4,1 (1ct 0st),0.181,
12,Amjad Mahboob (SGP),2019-2020,14,14,4,4,0,0,4,1 (1ct 0st),0.285,
13,A Andrews (SUI),2021-2021,3,3,4,4,0,0,4,2 (2ct 0st),1.333,
14,DK Anefie (Ghana),2019-2021,11,11,4,4,0,0,4,3 (3ct 0st),0.363,
15,Anwar Rahman (MAL),2019-2021,14,14,4,4,0,0,4,1 (1ct 0st),0.285,
16,JC Archer (ENG),2019-2021,12,12,4,4,0,0,4,2 (2ct 0st),0.333,
17,B Arora (MLT),2019-2021,21,21,4,4,0,0,4,2 (2ct 0st),0.19,
18,Arsalan Arif (Aut),2019-2021,2,2,4,3,1,0,3,3 (3ct 0st),2.0,
19,Arsalan Ahmed (GRC),2019-2021,6,6,4,4,0,0,4,2 (2ct 0st),0.666,
20,Aslam Mohammad (GRC),2019-2021,6,6,4,4,0,0,4,2 (2ct 0st),0.666,
21,Awais Malik (QAT),2019-2020,18,18,4,4,0,0,4,2 (2ct 0st),0.222,
22,SKA Awiah (Ghana),2021-2021,11,11,4,4,0,0,4,1 (1ct 0st),0.363,
23,G Bakiweyem (Ghana),2019-2021,12,12,4,4,0,0,4,1 (1ct 0st),0.333,
24,B Banerjee (Mex),2019-2019,6,6,4,4,0,3,1,1 (1ct 0st),0.666,
25,TC Barker (LUX),2019-2021,12,12,4,4,0,0,4,2 (2ct 0st),0.333,
26,RR Behera (USA),2021-2021,2,2,4,4,0,0,4,2 (2ct 0st),2.0,
27,IR Bell (ENG),2006-2014,8,8,4,4,0,0,4,1 (1ct 0st),0.5,
28,TS Bharaj (DEN),2019-2021,10,10,4,4,0,0,4,3 (3ct 0st),0.4,
29,K Bhurtel (NEPAL),2021-2021,5,5,4,4,0,0,4,2 (2ct 0st),0.8,
30,MP Biddappa (PHI),2019-2019,3,3,4,3,1,3,0,2 (2ct 0st),1.333,
31,PRP Boissevain (NED),2019-2021,7,7,4,4,0,0,4,2 (2ct 0st),0.571,
32,SE Bond (NZ),2005-2010,20,20,4,4,0,0,4,1 (1ct 0st),0.2,
33,NT Broom (NZ),2009-2017,11,11,4,4,0,0,4,1 (1ct 0st),0.363,
34,DE Budge (SCOT),2018-2021,8,8,4,4,0,0,4,1 (1ct 0st),0.5,
35,J Butler (IOM),2020-2021,5,5,4,4,0,0,4,2 (2ct 0st),0.8,
36,G Chaturvedi (MLT),2019-2021,10,10,4,4,0,0,4,2 (2ct 0st),0.4,
37,JW Chilia (VAN),2019-2019,14,14,4,4,0,0,4,2 (2ct 0st),0.285,
38,K Christie (HKG),2019-2019,11,11,4,4,0,0,4,1 (1ct 0st),0.363,
39,SR Clark (AUS),2006-2007,9,9,4,4,0,0,4,1 (1ct 0st),0.444,
40,WJ Cope (LUX),2020-2021,12,12,4,4,0,0,4,2 (2ct 0st),0.333,
41,DDP D'Silva (UAE),2019-2019,10,10,4,4,0,0,4,1 (1ct 0st),0.4,
42,DAP Darrell (BMUDA),2019-2019,10,10,4,4,0,0,4,2 (2ct 0st),0.4,
43,TN de Grooth (NED),2008-2013,14,14,4,4,0,0,4,2 (2ct 0st),0.285,
44,Delawar Khan (DEN),2019-2021,16,16,4,4,0,0,4,2 (2ct 0st),0.25,
45,JL Denly (ENG),2009-2020,12,12,4,4,0,0,4,1 (1ct 0st),0.333,
46,Devender Singh (Ghana),2021-2021,11,11,4,4,0,0,4,2 (2ct 0st),0.363,
47,S Dhaniram (CAN),2008-2010,11,11,4,4,0,0,4,2 (2ct 0st),0.363,
48,Elias Sunny (BAN),2012-2012,7,7,4,4,0,0,4,3 (3ct 0st),0.571,
49,GD Elliott (NZ/World),2009-2017,17,17,4,4,0,0,4,2 (2ct 0st),0.235,
0,Fahad Tariq (UAE),2016-2016,6,6,4,4,0,0,4,3 (3ct 0st),0.666,
1,Faisal Khan (Saudi),2019-2021,11,11,4,4,0,0,4,1 (1ct 0st),0.363,
2,Farhad Reza (BAN),2006-2014,13,13,4,4,0,0,4,1 (1ct 0st),0.307,
3,LH Ferguson (NZ),2017-2021,14,14,4,4,0,0,4,2 (2ct 0st),0.285,
4,BC Fortuin (SA),2019-2021,13,13,4,4,0,0,4,2 (2ct 0st),0.307,
5,O Fournier (CRC),2019-2019,2,2,4,4,0,0,4,2 (2ct 0st),2.0,
6,PG Fulton (NZ),2006-2012,12,12,4,4,0,0,4,1 (1ct 0st),0.333,
7,Ghulam Ahmadi (GER),2021-2021,13,13,4,4,0,0,4,1 (1ct 0st),0.307,
8,D Gim (NGA),2019-2021,17,17,4,4,0,0,4,2 (2ct 0st),0.235,
9,G Goudie (SCOT),2010-2013,9,9,4,4,0,0,4,1 (1ct 0st),0.444,
10,CN Greaves (SCOT),2021-2021,9,9,4,4,0,0,4,2 (2ct 0st),0.444,
11,S Grover (CZK-R),2021-2021,4,4,4,4,0,3,1,2 (2ct 0st),1.0,
12,TGJ Gruijters (NED),2012-2013,8,8,4,4,0,0,4,2 (2ct 0st),0.5,
13,K Gupta (Chile),2019-2019,4,4,4,3,1,3,0,3 (2ct 1st),1.0,
14,RM Haq (SCOT),2007-2013,20,20,4,4,0,0,4,2 (2ct 0st),0.2,
15,P Hatchman (GIBR),2021-2021,9,9,4,4,0,0,4,2 (2ct 0st),0.444,
16,TM Head (AUS),2016-2018,16,16,4,4,0,0,4,1 (1ct 0st),0.25,
17,R Hekure (PNG),2019-2019,8,8,4,4,0,0,4,2 (2ct 0st),0.5,
18,BE Hendricks (SA),2014-2021,19,19,4,4,0,0,4,2 (2ct 0st),0.21,
19,DR Hooper (GUE),2019-2019,8,8,4,4,0,0,4,2 (2ct 0st),0.5,
20,AJ Hosein (WI),2021-2022,15,15,4,4,0,0,4,2 (2ct 0st),0.266,
21,A Husain (Arg),2019-2021,10,10,4,4,0,0,4,1 (1ct 0st),0.4,
22,DP Hyatt (WI),2011-2012,5,5,4,4,0,0,4,1 (1ct 0st),0.8,
23,Imran Khan (PORT),2019-2021,8,8,4,4,0,0,4,1 (1ct 0st),0.5,
24,Imrul Kayes (BAN),2010-2017,14,14,4,4,0,0,4,1 (1ct 0st),0.285,
25,HA Jackson (Fran),2021-2021,4,4,4,3,1,3,0,3 (3ct 0st),1.0,
26,GSNFG Jayasuriya (SL),2015-2020,18,18,4,4,0,0,4,1 (1ct 0st),0.222,
27,ST Jayasuriya (SL),2006-2011,31,31,4,4,0,0,4,1 (1ct 0st),0.129,
28,SHT Kandamby (SL),2008-2011,5,5,4,4,0,0,4,2 (2ct 0st),0.8,
29,AN Kervezee (NED),2009-2012,10,10,4,4,0,0,4,2 (2ct 0st),0.4,
30,Khalid Latif (PAK),2008-2016,13,13,4,4,0,0,4,1 (1ct 0st),0.307,
31,N Khanna (MLT),2019-2021,14,14,4,4,0,0,4,2 (2ct 0st),0.285,
32,Khizar Hayat (MAL),2020-2021,11,11,4,4,0,0,4,2 (2ct 0st),0.363,
33,AM Kimote (TAN),2021-2021,10,10,4,4,0,0,4,2 (2ct 0st),0.4,
34,MO Kitunda (TAN),2021-2021,3,3,4,1,3,1,0,3 (1ct 2st),1.333,
35,FA Klokker (DEN),2021-2021,6,6,4,2,2,2,0,4 (2ct 2st),0.666,
36,Kuldeep Lal (ESP),2019-2021,11,11,4,4,0,0,4,2 (2ct 0st),0.363,
37,Kushal Malla (NEPAL),2019-2021,10,10,4,4,0,0,4,2 (2ct 0st),0.4,
38,RE Levi (SA),2012-2012,12,12,4,4,0,0,4,1 (1ct 0st),0.333,
39,Lucky Ali (DEN),2019-2021,11,11,4,4,0,0,4,2 (2ct 0st),0.363,
40,N Madziva (ZIM),2015-2019,15,15,4,4,0,0,4,1 (1ct 0st),0.266,
41,Mahmud Jasat (PNM),2021-2021,6,6,4,4,0,0,4,2 (2ct 0st),0.666,
42,WJ Malinda (Mald),2019-2021,5,5,4,4,0,0,4,2 (2ct 0st),0.8,
43,G Manan (ROM),2019-2021,14,14,4,4,0,0,4,1 (1ct 0st),0.285,
44,MSS Mandy (Chile),2019-2019,4,4,4,4,0,0,4,1 (1ct 0st),1.0,
45,I Mansaray (SLE),2021-2021,4,4,4,4,0,4,0,2 (2ct 0st),1.0,
46,S Mba (NGA),2021-2021,8,8,4,4,0,0,4,2 (2ct 0st),0.5,
47,Md Nurul Huda (Fin),2019-2019,5,5,4,4,0,0,4,2 (2ct 0st),0.8,
48,AS Mehmi (GRC),2019-2021,6,6,4,4,0,0,4,2 (2ct 0st),0.666,
49,P Mishra (BUL),2019-2021,20,20,4,4,0,0,4,2 (2ct 0st),0.2,
0,Mohamed Arief (MAL),2019-2020,12,12,4,4,0,0,4,2 (2ct 0st),0.333,
1,Mohammad Amir (PAK),2009-2020,48,48,4,4,0,0,4,1 (1ct 0st),0.083,
2,Mohammad Ashraful (BAN),2007-2013,23,23,4,4,0,0,4,1 (1ct 0st),0.173,
3,Mohammad Boota (UAE),2019-2019,15,15,4,3,1,2,1,2 (1ct 1st),0.266,
4,Mohammad Mithun (BAN),2014-2021,15,15,4,4,0,0,4,2 (2ct 0st),0.266,
5,Mohammad Naveed (UAE),2015-2019,30,30,4,4,0,0,4,1 (1ct 0st),0.133,
6,Mohammad Wasim (1) (PAK),2021-2021,7,7,4,4,0,0,4,2 (2ct 0st),0.571,
7,M Morkel (SA/World),2007-2017,43,43,4,4,0,0,4,1 (1ct 0st),0.093,
8,Muhammad Awais (GRC),2019-2019,3,3,4,3,1,3,0,3 (2ct 1st),1.333,
9,D Muhumuza (UGA),2019-2021,25,25,4,4,0,0,4,1 (1ct 0st),0.16,
10,Mujeeb Ur Rahman (AFG),2018-2021,22,22,4,4,0,0,4,1 (1ct 0st),0.181,
11,PWA Mulder (SA),2021-2021,5,5,4,4,0,0,4,1 (1ct 0st),0.8,
12,GRD Munasinghe (ITA),2019-2019,7,7,4,4,0,0,4,1 (1ct 0st),0.571,
13,GBW Munaweera (QAT),2019-2021,16,16,4,4,0,0,4,1 (1ct 0st),0.25,
14,LA Musiani (Arg),2019-2021,10,10,4,4,0,0,4,1 (1ct 0st),0.4,
15,AK Muslar (Blz),2019-2021,9,9,4,1,3,0,1,1 (1ct 0st),0.444,
16,Muslim Yar (GER),2019-2021,12,12,4,4,0,0,4,2 (2ct 0st),0.333,
17,B Muzarabani (ZIM),2018-2021,21,21,4,4,0,0,4,1 (1ct 0st),0.19,
18,DM Nakrani (UGA),2019-2021,25,25,4,4,0,0,4,1 (1ct 0st),0.16,
19,Nazril Rahman (MAL),2019-2020,11,11,4,4,0,0,4,2 (2ct 0st),0.363,
20,D Ndikubwimana (RWN),2021-2021,5,5,4,3,1,3,0,2 (2ct 0st),0.8,
21,A Nehra (INDIA),2009-2017,27,27,4,4,0,0,4,1 (1ct 0st),0.148,
22,A Neill (SCOT),2019-2019,5,5,4,4,0,0,4,2 (2ct 0st),0.8,
23,SN Netravalkar (USA),2019-2021,14,14,4,4,0,0,4,1 (1ct 0st),0.285,
24,N Nipiko (VAN),2019-2019,14,14,4,4,0,0,4,1 (1ct 0st),0.285,
25,Noor Ali Zadran (AFG),2010-2017,20,20,4,4,0,0,4,1 (1ct 0st),0.2,
26,A Nortje (SA),2019-2021,16,16,4,4,0,0,4,1 (1ct 0st),0.25,
27,A Otwani (UGA),2019-2021,13,13,4,4,0,2,2,1 (1ct 0st),0.307,
28,JS Patel (NZ),2005-2008,11,11,4,4,0,0,4,1 (1ct 0st),0.363,
29,RK Paudel (NEPAL),2019-2019,11,11,4,4,0,0,4,2 (2ct 0st),0.363,
30,S Prasanna (SL),2013-2017,20,20,4,4,0,0,4,2 (2ct 0st),0.2,
31,A Pusthay (Fin),2019-2021,9,9,4,4,0,0,4,1 (1ct 0st),0.444,
32,AT Rayudu (INDIA),2014-2016,6,6,4,4,0,0,4,2 (2ct 0st),0.666,
33,Ali Raza (Belg),2021-2021,3,3,4,4,0,4,0,2 (2ct 0st),1.333,
34,B Regmi (NEPAL),2014-2019,17,17,4,4,0,0,4,1 (1ct 0st),0.235,
35,EB Ringera (KENYA),2019-2021,12,12,4,4,0,0,4,2 (2ct 0st),0.333,
36,MJG Rippon (NED),2013-2017,17,17,4,4,0,0,4,1 (1ct 0st),0.235,
37,R Sandaruwan (KUW),2019-2021,19,19,4,4,0,0,4,2 (2ct 0st),0.21,
38,Saqlain Haider (UAE),2016-2016,6,6,4,4,0,0,4,2 (2ct 0st),0.666,
39,II Selemani (TAN),2021-2021,10,10,4,4,0,0,4,1 (1ct 0st),0.4,
40,G Sesay (SLE),2021-2021,10,10,4,4,0,0,4,1 (1ct 0st),0.4,
41,Shaheryar Butt (Belg),2019-2021,11,11,4,4,0,0,4,1 (1ct 0st),0.363,
42,Usman Shahid (Fran),2021-2021,4,4,4,4,0,0,4,2 (2ct 0st),1.0,
43,I Sharma (INDIA),2008-2013,14,14,4,4,0,0,4,1 (1ct 0st),0.285,
44,D Sheeli (KUW),2019-2020,5,5,4,4,0,0,4,3 (3ct 0st),0.8,
45,B Shikongo (NAM),2019-2021,16,16,4,4,0,0,4,1 (1ct 0st),0.25,
46,Sikander Zulfiqar (NED),2016-2019,11,11,4,4,0,0,4,2 (2ct 0st),0.363,
47,Simandeep Singh (HKG),2019-2019,7,7,4,4,0,0,4,2 (2ct 0st),0.571,
48,H Singh (GER),2019-2021,23,23,4,4,0,0,4,1 (1ct 0st),0.173,
49,RM Siri (Arg),2019-2021,10,10,4,4,0,0,4,2 (2ct 0st),0.4,
0,OF Smith (WI),2018-2022,8,8,4,4,0,0,4,2 (2ct 0st),0.5,
1,JTS Sumerauer (JER),2019-2021,13,13,4,4,0,0,4,1 (1ct 0st),0.307,
2,GP Swann (ENG),2008-2012,36,36,4,4,0,0,4,1 (1ct 0st),0.111,
3,MJ Swepson (AUS),2018-2021,7,7,4,4,0,0,4,2 (2ct 0st),0.571,
4,ES Szwarczynski (NED),2008-2013,13,13,4,4,0,0,4,2 (2ct 0st),0.307,
5,Tanwir Afzal (HKG),2014-2016,21,21,4,4,0,0,4,1 (1ct 0st),0.19,
6,RN ten Doeschate (NED),2008-2021,23,23,4,4,0,0,4,1 (1ct 0st),0.173,
7,S Thakor (TAN),2021-2021,10,10,4,4,0,0,4,2 (2ct 0st),0.4,
8,NK Tiwari (CYP),2021-2021,6,6,4,4,0,0,4,2 (2ct 0st),0.666,
9,C Tommy (VAN),2019-2019,12,12,4,4,0,0,4,1 (1ct 0st),0.333,
10,T Tshose (BOT),2019-2021,5,5,4,4,0,0,4,1 (1ct 0st),0.8,
11,I Udana (SL),2009-2021,34,34,4,4,0,0,4,2 (2ct 0st),0.117,
12,Umar Adam (Mald),2019-2021,17,17,4,4,0,0,4,2 (2ct 0st),0.235,
13,Umar Amin (PAK),2013-2018,14,14,4,4,0,0,4,1 (1ct 0st),0.285,
14,LV van Beek (NED),2014-2021,10,10,4,4,0,0,4,1 (1ct 0st),0.4,
15,DLS van Bunge (NED),2008-2013,13,13,4,4,0,0,4,2 (2ct 0st),0.307,
16,M van Lingen (NAM),2021-2021,8,8,4,4,0,0,4,2 (2ct 0st),0.5,
17,Arjun Vinod (SUI),2021-2021,4,4,4,4,0,0,4,2 (2ct 0st),1.0,
18,C Waiswa (UGA),2019-2021,10,10,4,4,0,0,4,1 (1ct 0st),0.4,
19,RR Watson (SCOT),2007-2010,9,9,4,4,0,0,4,2 (2ct 0st),0.444,
20,K Weeraratne (SL),2008-2009,5,5,4,4,0,0,4,2 (2ct 0st),0.8,
21,Yasir Shah (PAK),2011-2011,2,2,4,4,0,0,4,3 (3ct 0st),2.0,
22,Zahoor Khan (UAE),2017-2021,25,25,4,4,0,0,4,1 (1ct 0st),0.16,
23,Zameer Khan (DEN),2019-2021,8,8,4,3,1,2,1,2 (1ct 1st),0.5,
24,Ziaur Rahman (BAN),2012-2014,14,14,4,4,0,0,4,2 (2ct 0st),0.285,
25,Aaron Jones (USA),2019-2021,13,13,3,3,0,0,3,1 (1ct 0st),0.23,
26,Abdullah Akbarjan (Aut),2019-2021,8,8,3,3,0,0,3,1 (1ct 0st),0.375,
27,Abdul Waheed (Saudi),2020-2021,7,7,3,3,0,0,3,2 (2ct 0st),0.428,
28,Abdul Wahid (Saudi),2019-2021,12,12,3,3,0,0,3,1 (1ct 0st),0.25,
29,KD Abeyrathna (NOR),2021-2021,5,5,3,3,0,1,2,2 (2ct 0st),0.6,
30,Aftab Alam (AFG),2012-2018,12,12,3,3,0,0,3,2 (2ct 0st),0.25,
31,KK Ahmed (INDIA),2018-2019,13,13,3,3,0,0,3,1 (1ct 0st),0.23,
32,Ahmed Hassan (Mald),2019-2021,14,14,3,3,0,0,3,2 (2ct 0st),0.214,
33,Ainool Haqqiem (MAL),2019-2019,4,4,3,1,2,1,0,2 (0ct 2st),0.75,
34,F Akankwasa (UGA),2020-2021,23,23,3,3,0,0,3,2 (2ct 0st),0.13,
35,Ali Masood (EST),2021-2021,6,6,3,3,0,0,3,2 (2ct 0st),0.5,
36,TP Allen (USA),2019-2019,5,5,3,3,0,0,3,1 (1ct 0st),0.6,
37,Amandeep Singh (PORT),2021-2021,4,4,3,3,0,0,3,2 (2ct 0st),0.75,
38,Amir Mangal (GER),2019-2020,10,10,3,3,0,0,3,2 (2ct 0st),0.3,
39,Amir Sharif (ITA),2021-2021,3,3,3,3,0,0,3,2 (2ct 0st),1.0,
40,Amjad Sher (Fin),2019-2021,9,9,3,3,0,0,3,1 (1ct 0st),0.333,
41,MK Anafie (Ghana),2021-2021,10,10,3,3,0,0,3,1 (1ct 0st),0.3,
42,Anasim Khan (BHR),2019-2021,12,12,3,3,0,0,3,1 (1ct 0st),0.25,
43,JM Anderson (ENG),2007-2009,18,18,3,3,0,0,3,1 (1ct 0st),0.166,
44,Anowarul Islam (THAI),2019-2019,4,4,3,3,0,0,3,2 (2ct 0st),0.75,
45,MJ Ansell (IOM),2020-2021,5,5,3,3,0,0,3,3 (3ct 0st),0.6,
46,Ansh Tandon (UAE),2020-2020,1,1,3,3,0,0,3,3 (3ct 0st),3.0,
47,Anwar Arudin (MAL),2019-2021,20,20,3,3,0,0,3,1 (1ct 0st),0.15,
48,P Arrighi (Arg),2019-2019,5,5,3,3,0,0,3,2 (2ct 0st),0.6,
49,Asad Shafiq (PAK),2010-2012,10,10,3,3,0,0,3,1 (1ct 0st),0.3,
0,NJ Astle (NZ),2005-2006,4,4,3,3,0,0,3,2 (2ct 0st),0.75,
1,TD Astle (NZ),2016-2021,5,5,3,3,0,0,3,1 (1ct 0st),0.6,
2,F Baaleri (Ghana),2019-2019,4,4,3,3,0,1,2,2 (2ct 0st),0.75,
3,Babar Ali (BHR),2019-2019,3,3,3,3,0,0,3,1 (1ct 0st),1.0,
4,R Bakum (Ghana),2019-2021,15,15,3,3,0,0,3,2 (2ct 0st),0.2,
5,OGL Bascome (BMUDA),2019-2021,16,16,3,3,0,0,3,1 (1ct 0st),0.187,
6,V Baskaran (SGP),2019-2020,13,13,3,3,0,0,3,1 (1ct 0st),0.23,
7,EF Beard (IOM),2021-2021,4,4,3,3,0,0,3,1 (1ct 0st),0.75,
8,Bilal Zalmai (Aut),2019-2021,8,8,3,3,0,0,3,2 (2ct 0st),0.375,
9,C Bisson (JER),2019-2019,14,14,3,3,0,0,3,1 (1ct 0st),0.214,
10,DA Blignaut (GER),2021-2021,11,11,3,3,0,0,3,2 (2ct 0st),0.272,
11,TA Blundell (NZ),2017-2021,7,7,3,3,0,1,2,1 (1ct 0st),0.428,
12,SSJ Brooks (WI),2021-2021,3,3,3,3,0,0,3,1 (1ct 0st),1.0,
13,DG Brownlie (NZ),2010-2014,5,5,3,3,0,0,3,1 (1ct 0st),0.6,
14,J Bulele (MOZ),2019-2021,10,10,3,3,0,0,3,2 (2ct 0st),0.3,
15,IG Butler (NZ),2009-2013,18,18,3,3,0,0,3,1 (1ct 0st),0.166,
16,C Campher (IRE),2021-2021,9,9,3,3,0,0,3,1 (1ct 0st),0.333,
17,C Carter (HKG),2015-2017,10,10,3,2,1,2,0,1 (1ct 0st),0.3,
18,RD Chahar (INDIA),2019-2021,6,6,3,3,0,0,3,2 (2ct 0st),0.5,
19,PC Connell (IRE),2008-2010,8,8,3,3,0,0,3,1 (1ct 0st),0.375,
20,CJ Dala (SA),2018-2021,10,10,3,3,0,0,3,1 (1ct 0st),0.3,
21,F Damiao Couana (MOZ),2019-2021,10,10,3,3,0,0,3,1 (1ct 0st),0.3,
22,SM Davies (ENG),2009-2011,5,5,3,2,1,2,0,2 (2ct 0st),0.6,
23,S Davizi (CZK-R),2019-2021,13,13,3,3,0,0,3,1 (1ct 0st),0.23,
24,CD de Lange (SCOT),2015-2017,7,7,3,3,0,0,3,1 (1ct 0st),0.428,
25,CJ Delany (GIBR),2019-2021,13,13,3,3,0,0,3,1 (1ct 0st),0.23,
26,Dipanjan Dey (SWE),2021-2021,6,6,3,3,0,0,3,1 (1ct 0st),0.5,
27,Fayyaz Butt (OMA),2019-2021,16,16,3,3,0,0,3,1 (1ct 0st),0.187,
28,A Ferguson (Arg),2019-2021,11,11,3,3,0,1,2,1 (1ct 0st),0.272,
29,CRD Fernando (SL),2006-2016,18,18,3,3,0,0,3,1 (1ct 0st),0.166,
30,KJ Ferrary (GIBR),2021-2021,1,1,3,3,0,3,0,3 (3ct 0st),3.0,
31,BD Glover (NED),2019-2021,21,21,3,3,0,0,3,1 (1ct 0st),0.142,
32,LF Goncalves (),2019-2019,3,3,3,1,2,1,0,2 (1ct 1st),1.0,
33,K Gore (USA),2019-2021,8,8,3,3,0,0,3,1 (1ct 0st),0.375,
34,H Gori (CZK-R),2019-2020,11,11,3,3,0,0,3,1 (1ct 0st),0.272,
35,Z Groenewald (NAM),2019-2019,10,10,3,3,0,0,3,1 (1ct 0st),0.3,
36,Gurdeep Singh (KENYA),2021-2021,9,9,3,3,0,0,3,2 (2ct 0st),0.333,
37,Gurpratap Singh (CYP),2021-2021,6,6,3,3,0,0,3,1 (1ct 0st),0.5,
38,Haider Ali (PAK),2020-2021,21,21,3,3,0,0,3,1 (1ct 0st),0.142,
39,Hamid Hassan (AFG),2010-2021,25,25,3,3,0,0,3,1 (1ct 0st),0.12,
40,GM Hamilton (SCOT),2007-2010,11,11,3,3,0,0,3,2 (2ct 0st),0.272,
41,Haris Sohail (PAK),2013-2019,13,13,3,3,0,0,3,2 (2ct 0st),0.23,
42,E Haven (Bhm),2021-2021,6,6,3,2,1,1,1,2 (1ct 1st),0.5,
43,N Henderson (SUI),2021-2021,3,3,3,3,0,3,0,2 (2ct 0st),1.0,
44,K Hinds (Bhm),2021-2021,6,6,3,3,0,0,3,1 (1ct 0st),0.5,
45,S Hook (EST),2021-2021,5,5,3,2,1,2,0,2 (1ct 1st),0.6,
46,JR Hopes (AUS),2005-2010,12,12,3,3,0,0,3,1 (1ct 0st),0.25,
47,Ibrahim Hassan (Mald),2019-2021,17,17,3,3,0,0,3,1 (1ct 0st),0.176,
48,Ibrarul Haq (Saudi),2019-2019,5,5,3,3,0,0,3,3 (3ct 0st),0.6,
49,Idrees Ul Haque (SUI),2021-2021,4,4,3,3,0,3,0,3 (3ct 0st),0.75,
0,Iftekar Jaman (CYP),2021-2021,2,2,3,3,0,0,3,2 (2ct 0st),1.5,
1,Imran Farhat (PAK),2010-2011,7,7,3,3,0,0,3,1 (1ct 0st),0.428,
2,Imran Khan (1) (PAK),2015-2015,3,3,3,3,0,0,3,2 (2ct 0st),1.0,
3,Inam-ul-Haq (QAT),2019-2019,11,11,3,3,0,0,3,1 (1ct 0st),0.272,
4,MM Iqbal (SCOT),2012-2013,6,6,3,3,0,0,3,1 (1ct 0st),0.5,
5,Izatullah Dawlatzai (AFG/GER),2012-2020,16,16,3,3,0,0,3,2 (2ct 0st),0.187,
6,W Jackson (MWI),2021-2021,2,2,3,3,0,0,3,2 (2ct 0st),1.5,
7,Jahurul Islam (BAN),2010-2013,3,3,3,3,0,0,3,1 (1ct 0st),1.0,
8,KA Jamieson (NZ),2020-2021,8,8,3,3,0,0,3,2 (2ct 0st),0.375,
9,Jaspreet Singh (ITA),2019-2021,10,10,3,3,0,0,3,1 (1ct 0st),0.3,
10,S Jora (NEPAL),2019-2019,6,6,3,3,0,0,3,1 (1ct 0st),0.5,
11,Jubaid Ahamed (Fran),2021-2021,4,4,3,3,0,0,3,1 (1ct 0st),0.75,
12,Junaid Siddique (UAE),2019-2020,13,13,3,3,0,0,3,1 (1ct 0st),0.23,
13,I Kaia (ZIM),2021-2021,1,1,3,3,0,0,3,3 (3ct 0st),3.0,
14,AB Kamara (SLE),2021-2021,9,9,3,3,0,0,3,1 (1ct 0st),0.333,
15,L Karlsson (SWE),2021-2021,7,7,3,3,0,0,3,2 (2ct 0st),0.428,
16,C Karunaratne (SL),2021-2021,14,14,3,3,0,0,3,2 (2ct 0st),0.214,
17,I Katzarski (BUL),2019-2021,8,8,3,3,0,0,3,2 (2ct 0st),0.375,
18,S Kaveri (Mex),2019-2019,7,7,3,3,0,0,3,2 (2ct 0st),0.428,
19,JM Kemp (SA),2005-2007,8,8,3,3,0,0,3,1 (1ct 0st),0.375,
20,Khurram Nawaz (OMA),2017-2020,19,19,3,3,0,0,3,1 (1ct 0st),0.157,
21,J Kila (PNG),2019-2021,13,13,3,3,0,0,3,2 (2ct 0st),0.23,
22,RK Kiseto (TAN),2021-2021,8,8,3,3,0,0,3,2 (2ct 0st),0.375,
23,AK Kitchen (NZ),2017-2018,4,4,3,3,0,0,3,2 (2ct 0st),0.75,
24,IGTR Kumara (Mald),2020-2020,3,3,3,3,0,0,3,3 (3ct 0st),1.0,
25,UKPW Kumaranayaka (KUW),2019-2021,8,8,3,3,0,0,3,1 (1ct 0st),0.375,
26,RAS Lakmal (SL),2011-2019,11,11,3,3,0,0,3,1 (1ct 0st),0.272,
27,L Lamin (SLE),2021-2021,10,10,3,3,0,0,3,1 (1ct 0st),0.3,
28,A Lark (Aut),2019-2019,5,5,3,3,0,0,3,1 (1ct 0st),0.6,
29,I Liyanage (QAT),2020-2021,11,11,3,3,0,0,3,1 (1ct 0st),0.272,
30,CA Lynn (AUS),2014-2018,17,17,3,3,0,0,3,1 (1ct 0st),0.176,
31,WK McCallan (IRE),2008-2009,8,8,3,3,0,0,3,1 (1ct 0st),0.375,
32,R McLaren (SA),2009-2014,12,12,3,3,0,0,3,1 (1ct 0st),0.25,
33,CD McMillan (NZ),2005-2007,8,8,3,3,0,0,3,2 (2ct 0st),0.375,
34,D Maisuria (BOT),2019-2021,10,10,3,3,0,0,3,1 (1ct 0st),0.3,
35,JN Malan (SA),2019-2021,11,11,3,3,0,0,3,1 (1ct 0st),0.272,
36,Mamoon Latif (Belg),2019-2021,11,11,3,3,0,0,3,2 (2ct 0st),0.272,
37,T Manders (BMUDA),2021-2021,6,6,3,3,0,0,3,3 (3ct 0st),0.5,
38,A Manousis (GRC),2019-2021,6,6,3,2,1,0,2,1 (1ct 0st),0.5,
39,J Marples (GIBR),2021-2021,9,9,3,3,0,3,0,1 (1ct 0st),0.333,
40,SE Marsh (AUS),2008-2016,15,15,3,3,0,0,3,2 (2ct 0st),0.2,
41,KR Mayers (WI),2020-2022,3,3,3,3,0,0,3,2 (2ct 0st),1.0,
42,RD McCann (IRE),2012-2012,3,3,3,1,2,1,0,2 (0ct 2st),1.0,
43,Md Shafiqul Haque (THAI),2019-2019,4,4,3,1,2,1,0,1 (1ct 0st),0.75,
44,Mehran Khan (OMA),2015-2019,18,18,3,3,0,0,3,1 (1ct 0st),0.166,
45,Mien Mehmood (PORT),2019-2021,7,7,3,3,0,0,3,1 (1ct 0st),0.428,
46,T Mishra (KENYA),2007-2013,15,15,3,3,0,0,3,1 (1ct 0st),0.2,
47,Mohammad Amin (KUW),2019-2020,9,9,3,3,0,0,3,1 (1ct 0st),0.333,
48,Mohammad Asif (PAK),2006-2010,11,11,3,3,0,0,3,1 (1ct 0st),0.272,
49,Mohammad Sami (PAK),2010-2016,13,13,3,3,0,0,3,1 (1ct 0st),0.23,
0,Muhammad Kashif (KUW),2019-2021,17,17,3,3,0,0,3,1 (1ct 0st),0.176,
1,Muhammad Younis (BHR),2020-2021,7,7,3,3,0,0,3,2 (2ct 0st),0.428,
2,JM Muirhead (AUS),2014-2014,5,5,3,3,0,0,3,1 (1ct 0st),0.6,
3,AA Mulla (CAN),2008-2008,4,4,3,1,2,1,0,1 (1ct 0st),0.75,
4,T Munyonga (ZIM),2019-2019,5,5,3,3,0,0,3,2 (2ct 0st),0.6,
5,TJ Murtagh (IRE),2012-2016,13,13,3,3,0,0,3,1 (1ct 0st),0.23,
6,Musa Shaheen (DEN),2019-2021,8,8,3,3,0,0,3,1 (1ct 0st),0.375,
7,Naeem Gull (),2021-2021,6,6,3,3,0,0,3,1 (1ct 0st),0.5,
8,Najeeb Tarakai (AFG),2014-2019,12,12,3,3,0,0,3,2 (2ct 0st),0.25,
9,Najjam Shahzad (PORT),2019-2021,8,8,3,3,0,0,3,1 (1ct 0st),0.375,
10,A Nanda (LUX),2019-2021,8,8,3,3,0,0,3,2 (2ct 0st),0.375,
11,N Nankov (BUL),2019-2021,5,5,3,3,0,0,3,1 (1ct 0st),0.6,
12,Naseem Khushi (OMA),2017-2021,16,16,3,3,0,1,2,1 (1ct 0st),0.187,
13,M Nasim Baras (AFG),2015-2015,3,3,3,3,0,0,3,2 (2ct 0st),1.0,
14,Nasum Ahmed (BAN),2021-2021,18,18,3,3,0,0,3,1 (1ct 0st),0.166,
15,Nawaf Ahmed (KUW),2019-2021,5,5,3,3,0,0,3,1 (1ct 0st),0.6,
16,Najmul Hossain Shanto (BAN),2019-2021,6,6,3,3,0,0,3,1 (1ct 0st),0.5,
17,A Ndlovu (ZIM),2019-2019,3,3,3,3,0,0,3,2 (2ct 0st),1.0,
18,PM Nevill (AUS),2016-2016,9,9,3,2,1,2,0,1 (1ct 0st),0.333,
19,OE Newey (GUE),2019-2019,6,6,3,2,1,2,0,1 (1ct 0st),0.5,
20,L Ngidi (SA),2017-2021,23,23,3,3,0,0,3,1 (1ct 0st),0.13,
21,HM Nicholls (NZ),2016-2021,10,10,3,3,0,0,3,2 (2ct 0st),0.3,
22,E Niyomugabo (RWN),2021-2021,11,11,3,3,0,0,3,1 (1ct 0st),0.272,
23,Noorkhan Ahmedi (SUI),2021-2021,4,4,3,3,0,0,3,2 (2ct 0st),0.75,
24,DO Obuya (KENYA),2007-2012,10,10,3,2,1,1,1,1 (1ct 0st),0.3,
25,IO Okpe (NGA),2019-2021,20,20,3,3,0,0,3,1 (1ct 0st),0.15,
26,SA Okpe (NGA),2019-2021,16,16,3,3,0,0,3,1 (1ct 0st),0.187,
27,OE Olaleye (NGA),2021-2021,5,5,3,3,0,0,3,1 (1ct 0st),0.6,
28,Osama Mahmood (SUI),2021-2021,4,4,3,3,0,0,3,1 (1ct 0st),0.75,
29,H Patel (CAN),2010-2021,15,15,3,3,0,0,3,1 (1ct 0st),0.2,
30,RB Patel (UGA),2021-2021,18,18,3,3,0,0,3,1 (1ct 0st),0.166,
31,RB Patel (BUL),2020-2021,8,8,3,3,0,0,3,1 (1ct 0st),0.375,
32,SR Patel (ENG),2011-2013,17,17,3,3,0,0,3,1 (1ct 0st),0.176,
33,JL Pattinson (AUS),2011-2012,4,4,3,3,0,0,3,2 (2ct 0st),0.75,
34,S Periyalwar (ROM),2019-2021,14,14,3,3,0,0,3,1 (1ct 0st),0.214,
35,RW Price (ZIM),2008-2012,16,16,3,3,0,0,3,1 (1ct 0st),0.187,
36,S Qeshile (SA),2019-2019,2,2,3,3,0,3,0,2 (2ct 0st),1.5,
37,PBB Rajapaksa (SL),2019-2021,17,17,3,3,0,0,3,1 (1ct 0st),0.176,
38,LN Rajbanshi (NEPAL),2019-2019,11,11,3,3,0,0,3,1 (1ct 0st),0.272,
39,S Ravikumar (CRC),2019-2019,3,3,3,3,0,0,3,2 (2ct 0st),1.0,
40,R Ravindra (NZ),2021-2021,6,6,3,3,0,0,3,2 (2ct 0st),0.5,
41,Raza Iqbal (NOR),2019-2021,10,10,3,3,0,0,3,2 (2ct 0st),0.3,
42,AJ Redmond (NZ),2009-2010,7,7,3,3,0,0,3,2 (2ct 0st),0.428,
43,KA Reynolds (Blz),2019-2019,3,3,3,3,0,0,3,2 (2ct 0st),1.0,
44,MJ Ross (ITA),2019-2019,7,7,3,3,0,0,3,2 (2ct 0st),0.428,
45,T Rossi (Arg),2021-2021,6,6,3,3,0,0,3,1 (1ct 0st),0.5,
46,D Sabir (BMUDA),2021-2021,3,3,3,3,0,0,3,2 (2ct 0st),1.0,
47,NA Saini (INDIA),2019-2021,10,10,3,3,0,0,3,2 (2ct 0st),0.3,
48,Salman Butt (PAK),2007-2010,24,24,3,3,0,0,3,1 (1ct 0st),0.125,
49,Sayed Monib (KUW),2020-2021,7,7,3,3,0,0,3,1 (1ct 0st),0.428,
0,JOP Scamans (Fin),2019-2021,6,6,3,3,0,3,0,2 (2ct 0st),0.5,
1,Amoluk Singh (Ghana),2021-2021,10,10,3,3,0,0,3,2 (2ct 0st),0.3,
2,SMSM Senanayake (SL),2012-2016,24,24,3,3,0,0,3,1 (1ct 0st),0.125,
3,Shahil Momin (Aut),2021-2021,3,3,3,3,0,0,3,2 (2ct 0st),1.0,
4,Shahzaib Hasan (PAK),2009-2010,10,10,3,3,0,0,3,2 (2ct 0st),0.3,
5,R Shepherd (WI),2020-2022,10,10,3,3,0,0,3,1 (1ct 0st),0.3,
6,Sheraz Sheikh (Belg),2021-2021,7,7,3,3,0,0,3,1 (1ct 0st),0.428,
7,NK Shetty (Mex),2019-2019,2,2,3,3,0,0,3,2 (2ct 0st),1.5,
8,Sidhant Singh (SGP),2019-2020,11,11,3,3,0,0,3,1 (1ct 0st),0.272,
9,M Simpson-Parker (Aut),2019-2021,10,10,3,3,0,0,3,1 (1ct 0st),0.3,
10,K Sinclair (WI),2021-2021,6,6,3,3,0,0,3,1 (1ct 0st),0.5,
11,S Singh (KENYA),2021-2021,5,5,3,3,0,0,3,3 (3ct 0st),0.6,
12,L Sipamla (SA),2019-2021,9,9,3,3,0,0,3,1 (1ct 0st),0.333,
13,NL Smith (ITA),2021-2021,6,6,3,3,0,0,3,2 (2ct 0st),0.5,
14,VS Solanki (ENG),2005-2007,3,3,3,3,0,2,1,2 (2ct 0st),1.0,
15,CA Soper (PNG),2015-2021,16,16,3,3,0,0,3,1 (1ct 0st),0.187,
16,SSM Stanislaus (MLT),2020-2021,20,20,3,3,0,0,3,1 (1ct 0st),0.15,
17,MWR Stokes (GUE),2019-2019,8,8,3,3,0,0,3,1 (1ct 0st),0.375,
18,AO Suji (KENYA),2007-2010,8,8,3,3,0,0,3,1 (1ct 0st),0.375,
19,Sulaiman Ali (BUL),2020-2021,13,13,3,3,0,0,3,1 (1ct 0st),0.23,
20,CR Suryawanshi (SGP),2019-2019,3,3,3,3,0,0,3,1 (1ct 0st),1.0,
21,A Symonds (AUS),2005-2009,14,14,3,3,0,0,3,1 (1ct 0st),0.214,
22,SW Tait (AUS),2007-2016,21,21,3,3,0,0,3,1 (1ct 0st),0.142,
23,MB Tambe (Fin),2021-2021,4,4,3,3,0,0,3,2 (2ct 0st),0.75,
24,Tauqeer Hussain (ESP),2019-2020,6,6,3,3,0,0,3,1 (1ct 0st),0.5,
25,DT Tiripano (ZIM),2016-2021,17,17,3,3,0,0,3,1 (1ct 0st),0.176,
26,OFJ Tonuu (Samoa),2019-2019,4,4,3,3,0,3,0,1 (1ct 0st),0.75,
27,BN Toube (CAM),2021-2021,4,4,3,3,0,0,3,2 (2ct 0st),0.75,
28,E Ul Haq (NOR),2019-2021,10,10,3,3,0,0,3,1 (1ct 0st),0.3,
29,JD Unadkat (INDIA),2016-2018,10,10,3,3,0,0,3,1 (1ct 0st),0.3,
30,Usman Arif (NOR),2021-2021,4,4,3,3,0,0,3,2 (2ct 0st),0.75,
31,D Uwimana (RWN),2021-2021,6,6,3,3,0,3,0,2 (2ct 0st),0.5,
32,P Vekaria (RWN),2021-2021,8,8,3,3,0,0,3,1 (1ct 0st),0.375,
33,A Venkatesh (SWE),2021-2021,7,7,3,3,0,0,3,2 (2ct 0st),0.428,
34,JK Vifah (Ghana),2019-2021,14,14,3,3,0,0,3,3 (3ct 0st),0.214,
35,M Vijay (INDIA),2010-2015,9,9,3,3,0,0,3,1 (1ct 0st),0.333,
36,AC Voges (AUS),2007-2013,6,6,3,3,0,0,3,1 (1ct 0st),0.5,
37,Wahidullah Sahak (NOR),2021-2021,4,4,3,3,0,0,3,2 (2ct 0st),0.75,
38,BJ Watling (NZ),2009-2014,4,4,3,3,0,2,1,1 (1ct 0st),0.75,
39,DS Wesonga (KENYA),2021-2021,3,3,3,3,0,0,3,2 (2ct 0st),1.0,
40,T Whiteman (LUX),2019-2021,14,14,3,3,0,0,3,1 (1ct 0st),0.214,
41,UT Yadav (INDIA),2012-2019,7,7,3,3,0,0,3,1 (1ct 0st),0.428,
42,C Zavoiu (ROM),2019-2021,11,11,3,3,0,0,3,1 (1ct 0st),0.272,
43,Zeeshan Khan (MLT),2021-2021,13,13,3,3,0,0,3,1 (1ct 0st),0.23,
44,Aasif Sheikh (NEPAL),2021-2021,5,5,2,2,0,0,2,1 (1ct 0st),0.4,
45,M Abdulla (MWI),2019-2021,10,10,2,2,0,0,2,1 (1ct 0st),0.2,
46,Abdul Razzaq (PAK),2006-2013,32,32,2,2,0,0,2,1 (1ct 0st),0.062,
47,AS Abioye (NGA),2019-2019,5,5,2,2,0,0,2,1 (1ct 0st),0.4,
48,IKO Aboagye (Ghana),2019-2019,4,4,2,2,0,0,2,1 (1ct 0st),0.5,
49,RA Abolarin (NGA),2019-2021,10,10,2,2,0,0,2,1 (1ct 0st),0.2,
0,Abu Hider (BAN),2016-2018,12,12,2,2,0,0,2,1 (1ct 0st),0.166,
1,VD Adewoye (NGA),2019-2021,13,13,2,2,0,0,2,1 (1ct 0st),0.153,
2,Adil Butt (Saudi),2020-2020,3,3,2,2,0,0,2,1 (1ct 0st),0.666,
3,Aftab Kayani (ROM),2020-2021,7,7,2,2,0,0,2,1 (1ct 0st),0.285,
4,N Ahir (PNM),2021-2021,5,5,2,2,0,0,2,1 (1ct 0st),0.4,
5,Khalid Zahid (SWE),2021-2021,7,7,2,2,0,0,2,1 (1ct 0st),0.285,
6,P Aho (NGA),2021-2021,16,16,2,2,0,0,2,1 (1ct 0st),0.125,
7,Ali Waqar (CZK-R),2021-2021,6,6,2,2,0,0,2,1 (1ct 0st),0.333,
8,M Akayezu (RWN),2021-2021,11,11,2,2,0,0,2,1 (1ct 0st),0.181,
9,J Albin (BUL),2021-2021,11,11,2,2,0,0,2,1 (1ct 0st),0.181,
10,AD Algar (ESP),2020-2020,1,1,2,2,0,2,0,2 (2ct 0st),2.0,
11,DI Allan (KENYA),2012-2013,10,10,2,2,0,0,2,1 (1ct 0st),0.2,
12,FH Allen (NZ),2021-2021,6,6,2,2,0,0,2,1 (1ct 0st),0.333,
13,Alok Kapali (BAN),2007-2011,7,7,2,2,0,0,2,1 (1ct 0st),0.285,
14,TR Ambrose (ENG),2008-2008,1,1,2,1,1,1,0,2 (1ct 1st),2.0,
15,Amir Zaib (PORT),2021-2021,4,4,2,2,0,0,2,1 (1ct 0st),0.5,
16,Amjad Khan (UAE),2015-2016,4,4,2,2,0,0,2,1 (1ct 0st),0.5,
17,Anamul Haque (BAN),2012-2015,12,12,2,2,0,1,1,1 (1ct 0st),0.166,
18,R Ankad (Mex),2019-2019,8,8,2,2,0,0,2,1 (1ct 0st),0.25,
19,Aphsal Ashraf (KUW),2020-2020,5,5,2,2,0,0,2,1 (1ct 0st),0.4,
20,Aqib Iqbal (Aut),2019-2021,12,12,2,2,0,0,2,1 (1ct 0st),0.166,
21,Areeb Quadir (Fin),2019-2019,2,2,2,2,0,0,2,2 (2ct 0st),1.0,
22,Ashfaq Ahmed (UAE),2018-2019,11,11,2,2,0,0,2,1 (1ct 0st),0.181,
23,Ashiqullah Said (Belg),2019-2021,12,12,2,2,0,0,2,1 (1ct 0st),0.166,
24,S Ashwathnarayana (HUN),2021-2021,4,4,2,2,0,2,0,1 (1ct 0st),0.5,
25,Asrar Ahmed (GRC),2019-2021,6,6,2,2,0,0,2,1 (1ct 0st),0.333,
26,Atif Kamal (LUX),2019-2021,8,8,2,2,0,0,2,1 (1ct 0st),0.25,
27,Ayaan Khan (OMA),2021-2021,2,2,2,2,0,0,2,1 (1ct 0st),1.0,
28,Aziz Mohammad (Belg),2019-2021,6,6,2,2,0,0,2,1 (1ct 0st),0.333,
29,KNA Bandara (SL),2021-2021,4,4,2,2,0,0,2,1 (1ct 0st),0.5,
30,AA Banner (Blz),2019-2021,9,9,2,2,0,0,2,2 (2ct 0st),0.222,
31,LJ Barker (GUE),2019-2020,9,9,2,2,0,0,2,1 (1ct 0st),0.222,
32,GEF Barnett (CAN),2008-2010,5,5,2,2,0,0,2,1 (1ct 0st),0.4,
33,CD Barnwell (WI),2011-2013,6,6,2,2,0,0,2,1 (1ct 0st),0.333,
34,Baz Aybui (SWE),2021-2021,4,4,2,2,0,0,2,1 (1ct 0st),0.5,
35,AR Berenger (QAT),2021-2021,4,4,2,2,0,0,2,1 (1ct 0st),0.5,
36,A Bhagwat (HKG),2019-2019,4,4,2,2,0,2,0,2 (2ct 0st),0.5,
37,RA Bhatti (CAN),2012-2012,4,4,2,1,1,1,0,1 (1ct 0st),0.5,
38,K Birkenstock (NAM),2019-2021,9,9,2,2,0,0,2,1 (1ct 0st),0.222,
39,DE Bollinger (AUS),2011-2014,9,9,2,2,0,0,2,1 (1ct 0st),0.222,
40,JP Bray (IRE),2009-2009,2,2,2,2,0,0,2,1 (1ct 0st),1.0,
41,GB Brent (ZIM),2006-2007,3,3,2,2,0,0,2,2 (2ct 0st),0.666,
42,PR Brown (ENG),2019-2019,4,4,2,2,0,0,2,1 (1ct 0st),0.5,
43,P Buccimazza (PORT),2019-2021,7,7,2,2,0,2,0,1 (1ct 0st),0.285,
44,G Burrows (IOM),2020-2021,5,5,2,2,0,0,2,2 (2ct 0st),0.4,
45,J Butler (GUE),2019-2020,9,9,2,2,0,0,2,1 (1ct 0st),0.222,
46,AF Buurman (NED),2010-2010,4,4,2,1,1,1,0,2 (1ct 1st),0.5,
47,ML Castillo (Blz),2021-2021,5,5,2,2,0,0,2,1 (1ct 0st),0.4,
48,CPPM Sadun (CYP),2021-2021,6,6,2,2,0,0,2,1 (1ct 0st),0.333,
49,VD Chandra (PNM),2019-2019,3,3,2,2,0,2,0,1 (1ct 0st),0.666,
0,BB Chari (ZIM),2019-2019,3,3,2,2,0,0,2,1 (1ct 0st),0.666,
1,PP Chawla (INDIA),2010-2012,7,7,2,2,0,0,2,2 (2ct 0st),0.285,
2,C Chete (MWI),2019-2021,7,7,2,2,0,2,0,1 (1ct 0st),0.285,
3,VB Chikkannaiah (GER),2019-2021,19,19,2,2,0,0,2,1 (1ct 0st),0.105,
4,S Conteh (SLE),2021-2021,10,10,2,2,0,0,2,1 (1ct 0st),0.2,
5,CK Coventry (ZIM),2010-2015,13,13,2,2,0,1,1,1 (1ct 0st),0.153,
6,KM Dabengwa (ZIM),2006-2010,8,8,2,2,0,0,2,1 (1ct 0st),0.25,
7,P Danci (ROM),2019-2020,4,4,2,2,0,0,2,2 (2ct 0st),0.5,
8,RR David (CAN),2008-2008,4,4,2,2,0,0,2,1 (1ct 0st),0.5,
9,JM Davison (CAN),2008-2010,5,5,2,2,0,0,2,1 (1ct 0st),0.4,
10,LA Dawson (ENG),2016-2022,8,8,2,2,0,0,2,1 (1ct 0st),0.25,
11,TB de Bruyn (SA),2017-2017,2,2,2,2,0,0,2,2 (2ct 0st),1.0,
12,N Deonarine (WI),2010-2013,8,8,2,2,0,0,2,2 (2ct 0st),0.25,
13,IA De Silva (BUL),2020-2021,16,16,2,2,0,0,2,1 (1ct 0st),0.125,
14,AP Devcich (NZ),2013-2014,4,4,2,2,0,0,2,2 (2ct 0st),0.5,
15,R Dhawan (INDIA),2016-2016,1,1,2,2,0,0,2,2 (2ct 0st),2.0,
16,GD Drummond (SCOT),2008-2013,17,17,2,2,0,0,2,1 (1ct 0st),0.117,
17,LA Dunbar (SRB),2019-2021,6,6,2,2,0,1,1,1 (1ct 0st),0.333,
18,AB Dursak (TKY),2019-2019,4,4,2,2,0,0,2,2 (2ct 0st),0.5,
19,E Dusingizimana (RWN),2021-2021,6,6,2,2,0,0,2,1 (1ct 0st),0.333,
20,GDR Eranga (CAN),2019-2019,8,8,2,2,0,0,2,1 (1ct 0st),0.25,
21,E Ernest (SLE),2021-2021,10,10,2,2,0,0,2,2 (2ct 0st),0.2,
22,Faisal Mehmood (Belg),2021-2021,3,3,2,2,0,0,2,1 (1ct 0st),0.666,
23,Faisal Mubashir (GER),2021-2021,6,6,2,2,0,0,2,1 (1ct 0st),0.333,
24,Faran Afzal (ESP),2019-2019,9,9,2,2,0,0,2,1 (1ct 0st),0.222,
25,N Pradeep (SL),2016-2021,16,16,2,2,0,0,2,1 (1ct 0st),0.125,
26,NJ Ferraby (JER),2019-2021,18,18,2,2,0,0,2,1 (1ct 0st),0.111,
27,SP Fleming (NZ),2005-2006,5,5,2,2,0,0,2,1 (1ct 0st),0.4,
28,DR Flynn (NZ),2008-2012,5,5,2,2,0,0,2,1 (1ct 0st),0.4,
29,JD Freyone (GIBR),2019-2019,4,4,2,2,0,0,2,2 (2ct 0st),0.5,
30,CJ Gannon (USA),2019-2019,4,4,2,2,0,0,2,2 (2ct 0st),0.5,
31,S Gasteratos (GRC),2021-2021,3,3,2,2,0,0,2,1 (1ct 0st),0.666,
32,R Gaznavi (SGP),2019-2020,5,5,2,2,0,0,2,1 (1ct 0st),0.4,
33,K Gilham (CZK-R),2020-2021,7,7,2,2,0,0,2,1 (1ct 0st),0.285,
34,J Grassi (ITA),2021-2021,6,6,2,2,0,0,2,1 (1ct 0st),0.333,
35,Habib Ahmadzai (Aut),2019-2019,2,2,2,2,0,0,2,1 (1ct 0st),1.0,
36,Habib Khan (EST),2021-2021,6,6,2,2,0,0,2,1 (1ct 0st),0.333,
37,Haider Butt (BHR),2021-2021,4,4,2,2,0,0,2,1 (1ct 0st),0.5,
38,OJ Hairs (SCOT),2019-2021,12,12,2,2,0,0,2,1 (1ct 0st),0.166,
39,Hammad Azam (PAK),2012-2013,5,5,2,2,0,0,2,1 (1ct 0st),0.4,
40,Jandu Hamoud (KUW),2019-2019,6,6,2,2,0,0,2,1 (1ct 0st),0.333,
41,AS Hansra (CAN),2012-2013,8,8,2,2,0,0,2,1 (1ct 0st),0.25,
42,Haroon Mughal (MLT),2019-2021,14,14,2,2,0,0,2,1 (1ct 0st),0.142,
43,Haseeb Amjad (HKG),2014-2016,18,18,2,2,0,0,2,1 (1ct 0st),0.111,
44,JW Hastings (AUS),2010-2016,9,9,2,2,0,0,2,1 (1ct 0st),0.222,
45,C Hauptfleisch (Caym),2019-2019,5,5,2,1,1,1,0,1 (1ct 0st),0.4,
46,JR Hazlewood (AUS),2013-2021,24,24,2,2,0,0,2,1 (1ct 0st),0.083,
47,Hazratullah Zazai (AFG),2016-2021,20,20,2,2,0,0,2,1 (1ct 0st),0.1,
48,L Hermida (Mex),2019-2019,5,5,2,2,0,0,2,1 (1ct 0st),0.4,
49,R Heyns (LUX),2020-2020,2,2,2,2,0,0,2,2 (2ct 0st),1.0,
0,RM Hira (NZ),2012-2013,13,13,2,2,0,0,2,1 (1ct 0st),0.153,
1,Hirenkumar Patel (Chile),2019-2019,4,4,2,2,0,0,2,1 (1ct 0st),0.5,
2,S Hirugade (Mex),2019-2019,6,6,2,2,0,0,2,1 (1ct 0st),0.333,
3,KC Hodsoll (BMUDA),2008-2021,4,4,2,2,0,0,2,1 (1ct 0st),0.5,
4,Z Hoque (THAI),2019-2020,7,7,2,2,0,0,2,1 (1ct 0st),0.285,
5,JJ Huo (MOZ),2019-2021,10,10,2,2,0,0,2,1 (1ct 0st),0.2,
6,J Hurley (Arg),2019-2021,7,7,2,2,0,0,2,1 (1ct 0st),0.285,
7,Ibrahim Jabarkhel (Fran),2021-2021,2,2,2,2,0,0,2,2 (2ct 0st),1.0,
8,Imran Anwar (BHR),2019-2021,12,12,2,2,0,0,2,1 (1ct 0st),0.166,
9,Imran Ali (KUW),2019-2019,4,4,2,2,0,0,2,2 (2ct 0st),0.5,
10,Imran Arif (Saudi),2021-2021,4,4,2,2,0,0,2,1 (1ct 0st),0.5,
11,CA Ingram (SA),2010-2012,9,9,2,2,0,0,2,1 (1ct 0st),0.222,
12,Irfan Ahmed (HKG),2014-2015,8,8,2,2,0,0,2,1 (1ct 0st),0.25,
13,O Isesele (NGA),2021-2021,5,5,2,2,0,0,2,1 (1ct 0st),0.4,
14,Ismat Ullah (),2019-2019,4,4,2,2,0,0,2,1 (1ct 0st),0.5,
15,Israr Khan (GER),2021-2021,2,2,2,2,0,0,2,2 (2ct 0st),1.0,
16,B Ivanov (BUL),2019-2021,9,9,2,2,0,0,2,2 (2ct 0st),0.222,
17,ZR Jabeneke (TAN),2021-2021,3,3,2,2,0,0,2,2 (2ct 0st),0.666,
18,DF Jacobs (THAI),2019-2020,8,8,2,2,0,0,2,1 (1ct 0st),0.25,
19,YYM Jakda (LES),2021-2021,6,6,2,2,0,0,2,1 (1ct 0st),0.333,
20,Joginder Sharma (INDIA),2007-2007,4,4,2,2,0,0,2,1 (1ct 0st),0.5,
21,GO Jones (ENG),2005-2006,2,2,2,2,0,2,0,1 (1ct 0st),1.0,
22,MBS Jonkman (NED),2010-2010,3,3,2,2,0,0,2,2 (2ct 0st),0.666,
23,Junaid Siddiqui (CAN),2012-2021,17,17,2,2,0,0,2,1 (1ct 0st),0.117,
24,MO Kain (USA),2021-2021,2,2,2,2,0,0,2,2 (2ct 0st),1.0,
25,Karweng NG (PHI),2019-2019,3,3,2,2,0,0,2,2 (2ct 0st),0.666,
26,MS Kasprowicz (AUS),2005-2005,2,2,2,2,0,0,2,1 (1ct 0st),1.0,
27,LP Kasturiarachchige (Aut),2021-2021,5,5,2,2,0,0,2,1 (1ct 0st),0.4,
28,SM Katich (AUS),2005-2006,3,3,2,2,0,0,2,1 (1ct 0st),0.666,
29,Z Khan (INDIA),2006-2012,17,17,2,2,0,0,2,1 (1ct 0st),0.117,
30,Khurram Khan (UAE),2014-2014,3,3,2,2,0,0,2,1 (1ct 0st),0.666,
31,Khushdil Shah (PAK),2019-2021,12,12,2,2,0,0,2,1 (1ct 0st),0.166,
32,M Klinger (AUS),2017-2017,3,3,2,2,0,0,2,1 (1ct 0st),0.666,
33,HGJM Kulatunga (SL),2008-2008,2,2,2,2,0,0,2,2 (2ct 0st),1.0,
34,JS Kundi (KENYA),2019-2019,6,6,2,2,0,0,2,1 (1ct 0st),0.333,
35,S Kushretha (LUX),2020-2020,4,4,2,2,0,0,2,1 (1ct 0st),0.5,
36,M Kyriacou (CYP),2021-2021,6,6,2,2,0,0,2,1 (1ct 0st),0.333,
37,Lemar Momand (SWE),2021-2021,4,4,2,2,0,0,2,2 (2ct 0st),0.5,
38,LC Le Tissier (GUE),2019-2020,9,9,2,2,0,0,2,2 (2ct 0st),0.222,
39,JN Loftie-Eaton (NAM),2021-2021,11,11,2,2,0,0,2,1 (1ct 0st),0.181,
40,MF Maharoof (SL),2006-2016,8,8,2,2,0,0,2,1 (1ct 0st),0.25,
41,S Mahmood (ENG),2019-2022,11,11,2,2,0,0,2,1 (1ct 0st),0.181,
42,NA Maiolo (ITA),2019-2019,7,7,2,2,0,0,2,1 (1ct 0st),0.285,
43,D Manani (ROM),2019-2021,3,3,2,2,0,0,2,2 (2ct 0st),0.666,
44,Mansoor Amjad (PAK),2008-2008,1,1,2,2,0,0,2,2 (2ct 0st),2.0,
45,A Martin (WI),2011-2011,1,1,2,2,0,0,2,2 (2ct 0st),2.0,
46,B Masaba (UGA),2019-2021,10,10,2,2,0,0,2,1 (1ct 0st),0.2,
47,SW Masakadza (ZIM),2010-2013,7,7,2,2,0,0,2,1 (1ct 0st),0.285,
48,WT Mashinge (ZIM),2019-2019,2,2,2,2,0,0,2,2 (2ct 0st),1.0,
49,B Mavuta (ZIM),2018-2021,5,5,2,2,0,0,2,1 (1ct 0st),0.4,
0,R Mazumder (CYP),2021-2021,6,6,2,2,0,0,2,2 (2ct 0st),0.333,
1,A McAuley (IOM),2020-2021,5,5,2,2,0,0,2,1 (1ct 0st),0.4,
2,K Mendon (CZK-R),2019-2021,17,17,2,2,0,0,2,1 (1ct 0st),0.117,
3,NO Miller (WI),2009-2014,9,9,2,2,0,0,2,1 (1ct 0st),0.222,
4,SF Mire (ZIM),2018-2019,9,9,2,2,0,0,2,1 (1ct 0st),0.222,
5,RP Mitchell (Bhm),2021-2021,5,5,2,2,0,0,2,1 (1ct 0st),0.4,
6,Mohameed Taiwo (NGA),2019-2021,11,11,2,2,0,0,2,1 (1ct 0st),0.181,
7,Mohammad Ghazanfar (HKG),2019-2019,5,5,2,2,0,0,2,1 (1ct 0st),0.4,
8,Mohammad Salman (PAK),2011-2011,1,1,2,1,1,1,0,2 (1ct 1st),2.0,
9,Mohammed Asghar (KUW),2019-2019,4,4,2,2,0,0,2,1 (1ct 0st),0.5,
10,Mohammed Nurji (MWI),2019-2019,5,5,2,2,0,0,2,1 (1ct 0st),0.4,
11,M Mooketsi (BOT),2019-2021,11,11,2,2,0,0,2,1 (1ct 0st),0.181,
12,RS Morton (WI),2006-2010,7,7,2,2,0,0,2,1 (1ct 0st),0.285,
13,JWN Moses (BOT),2019-2021,7,7,2,2,0,0,2,1 (1ct 0st),0.285,
14,FJ Mpegna (CAM),2021-2021,4,4,2,2,0,0,2,2 (2ct 0st),0.5,
15,Muhammad Nadeem (Saudi),2019-2019,5,5,2,2,0,0,2,2 (2ct 0st),0.4,
16,Muhammad Waseem (UAE),2021-2021,4,4,2,2,0,0,2,1 (1ct 0st),0.5,
17,RG Mukasa (UGA),2019-2021,9,9,2,2,0,0,2,1 (1ct 0st),0.222,
18,Mukhtar Ahmed (PAK),2015-2015,6,6,2,2,0,0,2,1 (1ct 0st),0.333,
19,J Mulder (IRE),2016-2017,8,8,2,2,0,0,2,1 (1ct 0st),0.25,
20,G Murali (CRC),2019-2019,3,3,2,2,0,2,0,1 (1ct 0st),0.666,
21,Musawar Shah (QAT),2019-2021,8,8,2,2,0,0,2,1 (1ct 0st),0.25,
22,A Mustafa (Arg),2021-2021,1,1,2,2,0,0,2,2 (2ct 0st),2.0,
23,CT Mutombodzi (ZIM),2013-2020,15,15,2,2,0,0,2,1 (1ct 0st),0.133,
24,D Myers (ZIM),2021-2021,8,8,2,2,0,0,2,1 (1ct 0st),0.25,
25,Naeem Islam (BAN),2008-2013,10,10,2,2,0,0,2,1 (1ct 0st),0.2,
26,Nanda Kumar (CRC),2019-2019,3,3,2,2,0,0,2,2 (2ct 0st),0.666,
27,K Nassoro (TAN),2021-2021,10,10,2,2,0,0,2,1 (1ct 0st),0.2,
28,A Nathwani (Aut),2019-2021,7,7,2,2,0,0,2,1 (1ct 0st),0.285,
29,Naved-ul-Hasan (PAK),2006-2010,4,4,2,2,0,0,2,1 (1ct 0st),0.5,
30,Naveen-ul-Haq (AFG),2019-2021,13,13,2,2,0,0,2,1 (1ct 0st),0.153,
31,Nawazish Jezuli (Saudi),2019-2019,1,1,2,2,0,2,0,2 (2ct 0st),2.0,
32,Nazmul Islam (BAN),2018-2018,13,13,2,2,0,0,2,1 (1ct 0st),0.153,
33,Nazwan Ismail (Mald),2019-2020,4,4,2,2,0,0,2,1 (1ct 0st),0.5,
34,P Negi (INDIA),2016-2016,1,1,2,2,0,0,2,2 (2ct 0st),2.0,
35,R Ngarava (ZIM),2019-2021,18,18,2,2,0,0,2,2 (2ct 0st),0.111,
36,SF Nhavotso (MOZ),2021-2021,4,4,2,2,0,0,2,1 (1ct 0st),0.5,
37,TW Nightingale (GUE),2020-2020,1,1,2,2,0,0,2,2 (2ct 0st),2.0,
38,G Nikitas (GRC),2019-2019,2,2,2,0,2,0,0,2 (0ct 2st),1.0,
39,P Nissanka (SL),2021-2021,12,12,2,2,0,0,2,1 (1ct 0st),0.166,
40,Noor Momand (Belg),2019-2019,2,2,2,2,0,2,0,1 (1ct 0st),1.0,
41,M Ntini (SA),2005-2011,10,10,2,2,0,0,2,1 (1ct 0st),0.2,
42,MMR Obili (EST),2021-2021,6,6,2,2,0,0,2,1 (1ct 0st),0.333,
43,GH O'Brien (BMUDA),2008-2019,10,10,2,2,0,0,2,1 (1ct 0st),0.2,
44,E Ochieng (KENYA),2019-2021,7,7,2,2,0,0,2,1 (1ct 0st),0.285,
45,LN Oluoch (KENYA),2013-2019,10,10,2,2,0,0,2,1 (1ct 0st),0.2,
46,Omar Hayat (DEN),2019-2021,4,4,2,2,0,0,2,1 (1ct 0st),0.5,
47,Omar Hussain (LES),2021-2021,6,6,2,2,0,0,2,1 (1ct 0st),0.333,
48,Omar Rassol (BUL),2021-2021,7,7,2,2,0,2,0,1 (1ct 0st),0.285,
49,AA Onikoyi (NGA),2019-2021,14,14,2,2,0,2,0,1 (1ct 0st),0.142,
0,E Otieno (KENYA),2012-2021,25,25,2,2,0,0,2,1 (1ct 0st),0.08,
1,KO Otieno (KENYA),2008-2008,4,4,2,2,0,0,2,1 (1ct 0st),0.5,
2,HC Overdijk (NED),2019-2019,3,3,2,2,0,0,2,2 (2ct 0st),0.666,
3,AM Oyede (NGA),2019-2019,8,8,2,2,0,0,2,2 (2ct 0st),0.25,
4,E Packard (GIBR),2019-2021,8,8,2,2,0,0,2,1 (1ct 0st),0.25,
5,T Panyangara (ZIM),2013-2016,14,14,2,2,0,0,2,1 (1ct 0st),0.142,
6,AE Paraam (SGP),2019-2019,3,3,2,2,0,0,2,1 (1ct 0st),0.666,
7,SD Parry (ENG),2014-2015,5,5,2,2,0,0,2,2 (2ct 0st),0.4,
8,AAA Patel (LES),2021-2021,6,6,2,2,0,0,2,1 (1ct 0st),0.333,
9,IK Pathan (INDIA),2006-2012,23,23,2,2,0,0,2,1 (1ct 0st),0.086,
10,SN Pathirana (CYP),2021-2021,4,4,2,2,0,2,0,2 (2ct 0st),0.5,
11,KMA Paul (WI),2018-2020,20,20,2,2,0,0,2,1 (1ct 0st),0.1,
12,P Suanchuai (THAI),2020-2020,4,4,2,1,1,1,0,1 (1ct 0st),0.5,
13,JE Pitcher (BMUDA),2019-2019,3,3,2,2,0,0,2,2 (2ct 0st),0.666,
14,OL Pitcher (BMUDA),2008-2008,3,3,2,2,0,0,2,2 (2ct 0st),0.666,
15,SM Pollock (SA),2005-2008,12,12,2,2,0,0,2,1 (1ct 0st),0.166,
16,NS Poonia (SCOT),2007-2010,7,7,2,2,0,0,2,1 (1ct 0st),0.285,
17,A Poulose (OMA),2017-2017,3,3,2,2,0,0,2,1 (1ct 0st),0.666,
18,DBL Powell (WI),2007-2007,5,5,2,2,0,0,2,1 (1ct 0st),0.4,
19,AD Poynter (IRE),2012-2016,16,16,2,2,0,0,2,1 (1ct 0st),0.125,
20,Qadeer Ahmed (UAE),2015-2019,10,10,2,2,0,0,2,1 (1ct 0st),0.2,
21,Raaz Mohammad (Fin),2021-2021,4,4,2,2,0,0,2,1 (1ct 0st),0.5,
22,Raees Ahmadzai (AFG),2010-2010,8,8,2,2,0,0,2,1 (1ct 0st),0.25,
23,Raag Kapur (HKG),2019-2019,4,4,2,2,0,0,2,1 (1ct 0st),0.5,
24,Rahel Khan (SWE),2021-2021,7,7,2,2,0,0,2,1 (1ct 0st),0.285,
25,Raja Adeel (ESP),2019-2021,8,8,2,2,0,0,2,1 (1ct 0st),0.25,
26,S Rakshit (CZK-R),2019-2019,6,6,2,2,0,0,2,1 (1ct 0st),0.333,
27,R Rampaul (WI),2007-2021,26,26,2,2,0,0,2,1 (1ct 0st),0.076,
28,Rayhaan Ahmed (Aut),2021-2021,4,4,2,1,1,1,0,1 (1ct 0st),0.5,
29,Raza-ur-Rehman (CAN),2012-2013,5,5,2,2,0,0,2,1 (1ct 0st),0.4,
30,Raza Hasan (PAK),2012-2014,10,10,2,2,0,0,2,1 (1ct 0st),0.2,
31,Razmal Shigiwal (Aut),2019-2021,12,12,2,2,0,0,2,1 (1ct 0st),0.166,
32,DJ Reekers (NED),2008-2009,5,5,2,2,0,0,2,1 (1ct 0st),0.4,
33,GA Reynold (Blz),2019-2019,3,3,2,2,0,0,2,2 (2ct 0st),0.666,
34,LH Rodrigues (),2019-2019,4,4,2,2,0,0,2,1 (1ct 0st),0.5,
35,S Rossi (Arg),2019-2019,5,5,2,2,0,0,2,1 (1ct 0st),0.4,
36,C Rubagumya (RWN),2021-2021,11,11,2,2,0,0,2,1 (1ct 0st),0.181,
37,C Rumistrzewicz (ESP),2021-2021,2,2,2,2,0,0,2,1 (1ct 0st),1.0,
38,S Saeed (Mald),2019-2019,4,4,2,2,0,0,2,2 (2ct 0st),0.5,
39,Sagar Pun (NEPAL),2014-2015,9,9,2,2,0,0,2,1 (1ct 0st),0.222,
40,Sahel Zadran (Aut),2021-2021,7,7,2,2,0,0,2,1 (1ct 0st),0.285,
41,Sahibzada Farhan (PAK),2018-2018,3,3,2,2,0,0,2,2 (2ct 0st),0.666,
42,J Salazar (Peru),2019-2019,2,2,2,2,0,0,2,1 (1ct 0st),1.0,
43,Ali Nayyer (SUI),2021-2021,4,4,2,2,0,0,2,1 (1ct 0st),0.5,
44,Salman Nazar (CAN),2021-2021,4,4,2,2,0,0,2,1 (1ct 0st),0.5,
45,PD Salt (ENG),2022-2022,3,3,2,2,0,0,2,1 (1ct 0st),0.666,
46,S Samal (RWN),2021-2021,8,8,2,2,0,0,2,2 (2ct 0st),0.25,
47,Sami Ullah (ROM),2020-2021,9,9,2,2,0,0,2,2 (2ct 0st),0.222,
48,DR Sams (AUS),2020-2021,4,4,2,2,0,0,2,2 (2ct 0st),0.5,
49,Saqib Zulfiqar (NED),2018-2019,6,6,2,2,0,0,2,2 (2ct 0st),0.333,
0,Sarfaraz Ali (BHR),2019-2021,12,12,2,2,0,0,2,1 (1ct 0st),0.166,
1,A Sarma (GER),2019-2021,5,5,2,2,0,0,2,1 (1ct 0st),0.4,
2,A Sathya (Mex),2019-2019,3,3,2,2,0,0,2,1 (1ct 0st),0.666,
3,BV Save (MAL),2020-2020,2,2,2,2,0,0,2,2 (2ct 0st),1.0,
4,V Sehwag (INDIA),2006-2012,18,18,2,2,0,0,2,1 (1ct 0st),0.111,
5,Shaikh Ashraf (Peru),2019-2019,4,4,2,2,0,0,2,2 (2ct 0st),0.5,
6,Shakeel Ansar (PAK),2012-2012,2,2,2,1,1,1,0,2 (1ct 1st),1.0,
7,PH Shamdasani (Peru),2019-2019,4,4,2,2,0,0,2,1 (1ct 0st),0.5,
8,Shamsur Rahman (BAN),2013-2014,8,8,2,2,0,0,2,1 (1ct 0st),0.25,
9,V Shankar (INDIA),2018-2019,9,9,2,2,0,0,2,1 (1ct 0st),0.222,
10,A Sharafu (UAE),2020-2021,6,6,2,2,0,0,2,1 (1ct 0st),0.333,
11,Sherul Mehta (Belg),2020-2021,3,3,2,2,0,2,0,2 (2ct 0st),0.666,
12,Sher Sahak (NOR),2021-2021,5,5,2,2,0,0,2,1 (1ct 0st),0.4,
13,Shoaib Akhtar (PAK),2006-2010,15,15,2,2,0,0,2,1 (1ct 0st),0.133,
14,Shoaib Ali (Saudi),2019-2020,8,8,2,2,0,0,2,2 (2ct 0st),0.25,
15,Shoaib Qureshi (Fin),2019-2019,5,5,2,2,0,0,2,1 (1ct 0st),0.4,
16,ED Silva (KUW),2021-2021,4,4,2,2,0,0,2,2 (2ct 0st),0.5,
17,RP Singh (INDIA),2007-2009,9,9,2,2,0,0,2,1 (1ct 0st),0.222,
18,S Siriotis (GRC),2021-2021,3,3,2,2,0,0,2,1 (1ct 0st),0.666,
19,C Smith (IOM),2021-2021,4,4,2,2,0,0,2,1 (1ct 0st),0.5,
20,S Smith (BMUDA),2019-2019,5,5,2,2,0,2,0,1 (1ct 0st),0.4,
21,S Snater (NED),2018-2019,12,12,2,2,0,0,2,1 (1ct 0st),0.166,
22,Sohag Gazi (BAN),2012-2015,10,10,2,2,0,0,2,1 (1ct 0st),0.2,
23,S Sreesanth (INDIA),2006-2008,9,9,2,2,0,0,2,2 (2ct 0st),0.222,
24,JH Stander (SCOT),2009-2012,11,11,2,2,0,0,2,1 (1ct 0st),0.181,
25,F Stoman (PORT),2019-2019,4,4,2,1,1,1,0,2 (1ct 1st),0.5,
26,GM Strydom (Caym),2019-2019,6,6,2,2,0,0,2,1 (1ct 0st),0.333,
27,Surya Anand (DEN),2021-2021,8,8,2,2,0,0,2,1 (1ct 0st),0.25,
28,K Suttisan (THAI),2019-2019,2,2,2,2,0,0,2,2 (2ct 0st),1.0,
29,Syazrul Idrus (MAL),2019-2021,11,11,2,2,0,0,2,1 (1ct 0st),0.181,
30,Tahir Dar (BHR),2019-2019,4,4,2,2,0,0,2,1 (1ct 0st),0.5,
31,Taranjeet Singh (ROM),2021-2021,8,8,2,2,0,0,2,1 (1ct 0st),0.25,
32,Taskin Ahmed (BAN),2014-2021,31,31,2,2,0,0,2,1 (1ct 0st),0.064,
33,GT Taylor (Bhm),2021-2021,6,6,2,2,0,1,1,1 (1ct 0st),0.333,
34,M Taylor (Bhm),2021-2021,6,6,2,2,0,0,2,1 (1ct 0st),0.333,
35,P Taylor (CZK-R),2019-2021,11,11,2,2,0,0,2,1 (1ct 0st),0.181,
36,H Thaker (CAN),2019-2021,7,7,2,2,0,0,2,1 (1ct 0st),0.285,
37,WU Tharanga (SL),2006-2018,26,26,2,2,0,0,2,1 (1ct 0st),0.076,
38,M Theekshana (SL),2021-2021,10,10,2,2,0,0,2,1 (1ct 0st),0.2,
39,J Theron (SA/USA),2010-2021,13,13,2,2,0,0,2,1 (1ct 0st),0.153,
40,RA Thomas (CAN),2019-2019,7,7,2,2,0,0,2,1 (1ct 0st),0.285,
41,GJ Thompson (IRE),2016-2019,10,10,2,2,0,0,2,1 (1ct 0st),0.2,
42,T Thushara (SL),2008-2010,6,6,2,2,0,0,2,1 (1ct 0st),0.333,
43,MK Tiwary (INDIA),2011-2012,3,3,2,2,0,0,2,2 (2ct 0st),0.666,
44,JC Tredwell (ENG),2012-2014,16,16,2,2,0,0,2,1 (1ct 0st),0.125,
45,ME Trescothick (ENG),2005-2006,3,3,2,2,0,0,2,2 (2ct 0st),0.666,
46,RJ Trott (BMUDA),2008-2021,20,20,2,2,0,0,2,1 (1ct 0st),0.1,
47,R Ulutuna (TKY),2019-2019,4,4,2,2,0,2,0,2 (2ct 0st),0.5,
48,P Useni (NGA),2021-2021,16,16,2,2,0,0,2,1 (1ct 0st),0.125,
49,Usman Qadir (PAK),2020-2021,14,14,2,2,0,0,2,1 (1ct 0st),0.142,
0,RV Uthappa (INDIA),2007-2015,12,12,2,2,0,1,1,1 (1ct 0st),0.166,
1,M Vaik (EST),2021-2021,6,6,2,2,0,1,1,1 (1ct 0st),0.333,
2,R van der Merwe (Arg),2019-2019,5,5,2,2,0,0,2,1 (1ct 0st),0.4,
3,DV Varghese (BUL),2020-2021,12,12,2,2,0,0,2,1 (1ct 0st),0.166,
4,S Veerapathiran (BHR),2020-2021,5,5,2,2,0,0,2,1 (1ct 0st),0.4,
5,Vichanath Singh (THAI),2019-2020,8,8,2,2,0,0,2,1 (1ct 0st),0.25,
6,Vinod Kumar (ESP),2019-2020,4,4,2,2,0,0,2,2 (2ct 0st),0.5,
7,BV Vitori (ZIM),2012-2016,11,11,2,2,0,0,2,1 (1ct 0st),0.181,
8,Waheed Ahmed (UAE),2019-2020,15,15,2,2,0,0,2,1 (1ct 0st),0.133,
9,K Waiswa (UGA),2020-2021,12,12,2,2,0,0,2,1 (1ct 0st),0.166,
10,DKD Warnakulasuriya (ITA),2021-2021,2,2,2,2,0,0,2,1 (1ct 0st),1.0,
11,SR Welsh (CAN),2008-2008,1,1,2,2,0,0,2,2 (2ct 0st),2.0,
12,AR White (IRE),2008-2012,17,17,2,2,0,0,2,1 (1ct 0st),0.117,
13,S Wickramasekara (CZK-R),2019-2021,16,16,2,2,0,0,2,1 (1ct 0st),0.125,
14,N Wijesekera (Aut),2021-2021,4,4,2,2,0,0,2,1 (1ct 0st),0.5,
15,CG Williams (NAM),2019-2021,27,27,2,2,0,0,2,1 (1ct 0st),0.074,
16,LB Williams (SA),2021-2021,6,6,2,2,0,0,2,1 (1ct 0st),0.333,
17,OR Willis (Caym),2019-2019,3,3,2,1,1,0,1,1 (1ct 0st),0.666,
18,C Wright (Caym),2019-2019,6,6,2,2,0,0,2,1 (1ct 0st),0.333,
19,Yasar Haroon (),2019-2019,4,4,2,2,0,0,2,1 (1ct 0st),0.5,
20,Yasir Mehmood (CYP),2021-2021,4,4,2,2,0,0,2,2 (2ct 0st),0.5,
21,WA Young (NZ),2021-2021,8,8,2,2,0,0,2,1 (1ct 0st),0.25,
22,Zahid Abbas (KENYA),2021-2021,3,3,2,2,0,0,2,1 (1ct 0st),0.666,
23,Zeeshan Kukikhel (HUN),2021-2021,4,4,2,2,0,0,2,2 (2ct 0st),0.5,
24,C Zhuwao (ZIM),2008-2018,7,7,2,2,0,0,2,1 (1ct 0st),0.285,
25,Zishan Shah (DEN),2019-2019,4,4,2,2,0,0,2,1 (1ct 0st),0.5,
26,B Zuiderent (NED),2009-2010,6,6,2,2,0,0,2,1 (1ct 0st),0.333,
27,R Abdulkareem (NGA),2021-2021,7,7,1,1,0,0,1,1 (1ct 0st),0.142,
28,Abdul Shakoor (UAE),2015-2019,5,5,1,0,1,0,0,1 (0ct 1st),0.2,
29,Abraash Khan (CAN),2019-2019,6,6,1,1,0,0,1,1 (1ct 0st),0.166,
30,Absar Khan (DEN),2021-2021,2,2,1,1,0,0,1,1 (1ct 0st),0.5,
31,Abu Jayed (BAN),2018-2018,3,3,1,1,0,0,1,1 (1ct 0st),0.333,
32,AG Achar (SGP),2019-2020,5,5,1,1,0,0,1,1 (1ct 0st),0.2,
33,AR Adams (NZ),2005-2006,4,4,1,1,0,0,1,1 (1ct 0st),0.25,
34,Afsar Zazai (AFG),2013-2013,1,1,1,0,1,0,0,1 (0ct 1st),1.0,
35,Aaftab Alam Khan (MLT),2021-2021,5,5,1,1,0,1,0,1 (1ct 0st),0.2,
36,Aftab Hussain (HKG),2020-2020,9,9,1,1,0,0,1,1 (1ct 0st),0.111,
37,GJ Agius (MLT),2019-2019,2,2,1,1,0,0,1,1 (1ct 0st),0.5,
38,P Agnihotri (NOR),2019-2019,2,2,1,1,0,0,1,1 (1ct 0st),0.5,
39,D Ahir (PNM),2021-2021,5,5,1,1,0,0,1,1 (1ct 0st),0.2,
40,Ahmadschah Ahmadzai (GER),2021-2021,1,1,1,1,0,0,1,1 (1ct 0st),1.0,
41,Akif Raja (UAE),2021-2021,2,2,1,1,0,0,1,1 (1ct 0st),0.5,
42,GW Aldridge (NZ),2011-2011,1,1,1,1,0,0,1,1 (1ct 0st),1.0,
43,Ali Khan (USA),2021-2021,5,5,1,1,0,0,1,1 (1ct 0st),0.2,
44,Ali Raza (EST),2021-2021,3,3,1,1,0,0,1,1 (1ct 0st),0.333,
45,RGA Amah (CAM),2021-2021,4,4,1,1,0,0,1,1 (1ct 0st),0.25,
46,Aminul Islam (BAN),2019-2021,10,10,1,1,0,0,1,1 (1ct 0st),0.1,
47,Amir Ali (OMA),2015-2016,9,9,1,1,0,0,1,1 (1ct 0st),0.111,
48,Amir Hamza (AFG),2013-2021,33,33,1,1,0,0,1,1 (1ct 0st),0.03,
49,Amjad Ali (UAE),2014-2015,5,5,1,1,0,0,1,1 (1ct 0st),0.2,
0,Anam Mollik (ITA),2019-2019,2,2,1,1,0,0,1,1 (1ct 0st),0.5,
1,NK Aneesh Kumar (SUI),2021-2021,3,3,1,1,0,0,1,1 (1ct 0st),0.333,
2,S Arachchige (ITA),2019-2019,4,4,1,1,0,0,1,1 (1ct 0st),0.25,
3,Arafat Sunny (BAN),2014-2016,10,10,1,1,0,0,1,1 (1ct 0st),0.1,
4,Aritra Dutta (SGP),2019-2019,8,8,1,1,0,0,1,1 (1ct 0st),0.125,
5,P Arora (Mex),2019-2019,2,2,1,1,0,0,1,1 (1ct 0st),0.5,
6,Arshad Mazarzei (Iran),2020-2020,3,3,1,1,0,1,0,1 (1ct 0st),0.333,
7,Arslan Naseem (PORT),2021-2021,1,1,1,1,0,0,1,1 (1ct 0st),1.0,
8,U Aryaman Sunil (SGP),2019-2020,5,5,1,1,0,0,1,1 (1ct 0st),0.2,
9,Asad Ali Rehemtulla (BUL),2020-2020,3,3,1,1,0,0,1,1 (1ct 0st),0.333,
10,KIC Asalanka (SL),2021-2021,9,9,1,1,0,0,1,1 (1ct 0st),0.111,
11,SK Atai (PNG),2019-2021,7,7,1,1,0,0,1,1 (1ct 0st),0.142,
12,V Ateak (Ghana),2019-2019,4,4,1,1,0,0,1,1 (1ct 0st),0.25,
13,MS Aulakh (CAN),2012-2013,3,3,1,1,0,0,1,1 (1ct 0st),0.333,
14,Avi Dixit (SGP),2019-2019,1,1,1,1,0,0,1,1 (1ct 0st),1.0,
15,Azam Khan (PAK),2021-2021,2,2,1,1,0,0,1,1 (1ct 0st),0.5,
16,Aziz Sualley (Ghana),2021-2021,3,3,1,1,0,0,1,1 (1ct 0st),0.333,
17,Azyan Farhath (Mald),2019-2021,6,6,1,1,0,0,1,1 (1ct 0st),0.166,
18,R Baaleri (Ghana),2021-2021,2,2,1,1,0,0,1,1 (1ct 0st),0.5,
19,MO Bacarese (GIBR),2019-2019,3,3,1,1,0,0,1,1 (1ct 0st),0.333,
20,JD Baker (Samoa),2019-2019,4,4,1,1,0,0,1,1 (1ct 0st),0.25,
21,Bakhtiar Tahiri (BUL),2020-2021,10,10,1,1,0,0,1,1 (1ct 0st),0.1,
22,KF Bakiweyem (Ghana),2021-2021,3,3,1,1,0,0,1,1 (1ct 0st),0.333,
23,WD Balaji Rao (CAN),2008-2008,4,4,1,1,0,0,1,1 (1ct 0st),0.25,
24,Baljit Singh (ITA),2019-2021,8,8,1,1,0,0,1,1 (1ct 0st),0.125,
25,JT Ball (ENG),2018-2018,2,2,1,1,0,0,1,1 (1ct 0st),0.5,
26,CT Bancroft (AUS),2016-2016,1,1,1,1,0,1,0,1 (1ct 0st),1.0,
27,HMCM Bandara (SL),2006-2009,4,4,1,1,0,0,1,1 (1ct 0st),0.25,
28,S Bantzas (GRC),2019-2019,1,1,1,1,0,0,1,1 (1ct 0st),1.0,
29,AB Barath (WI),2010-2011,2,2,1,1,0,0,1,1 (1ct 0st),0.5,
30,JR Barry (Bhm),2021-2021,6,6,1,1,0,0,1,1 (1ct 0st),0.166,
31,OO Bascome (BMUDA),2008-2019,3,3,1,1,0,0,1,1 (1ct 0st),0.333,
32,Basil George (MLT),2021-2021,9,9,1,1,0,0,1,1 (1ct 0st),0.111,
33,GK Berg (ITA),2021-2021,6,6,1,1,0,0,1,1 (1ct 0st),0.166,
34,P Bhart (NOR),2019-2021,10,10,1,1,0,0,1,1 (1ct 0st),0.1,
35,RL Bhudia (KENYA),2007-2007,3,3,1,1,0,0,1,1 (1ct 0st),0.333,
36,SR Bhudia (KENYA),2019-2019,4,4,1,1,0,0,1,1 (1ct 0st),0.25,
37,Bilal Hassun (UGA),2021-2021,10,10,1,1,0,0,1,1 (1ct 0st),0.1,
38,Bilal Muhammad (MLT),2021-2021,18,18,1,1,0,0,1,1 (1ct 0st),0.055,
39,Bilawal Bhatti (PAK),2013-2015,9,9,1,1,0,0,1,1 (1ct 0st),0.111,
40,Z Bimenyimana (RWN),2021-2021,9,9,1,1,0,0,1,1 (1ct 0st),0.111,
41,D Birrell (JER),2021-2021,3,3,1,1,0,0,1,1 (1ct 0st),0.333,
42,TR Birt (AUS),2010-2012,4,4,1,1,0,0,1,1 (1ct 0st),0.25,
43,A Bishnoi (MLT),2021-2021,7,7,1,1,0,0,1,1 (1ct 0st),0.142,
44,D Bishoo (WI),2011-2019,7,7,1,1,0,0,1,1 (1ct 0st),0.142,
45,JAR Blain (SCOT),2007-2008,5,5,1,1,0,0,1,1 (1ct 0st),0.2,
46,SM Boland (AUS),2016-2016,3,3,1,1,0,0,1,1 (1ct 0st),0.333,
47,SG Borthwick (ENG),2011-2011,1,1,1,1,0,0,1,1 (1ct 0st),1.0,
48,LE Bosman (SA),2006-2010,14,14,1,1,0,0,1,1 (1ct 0st),0.071,
49,TS Braat (NED),2019-2021,6,6,1,1,0,0,1,1 (1ct 0st),0.166,
0,IDR Bradshaw (WI),2006-2006,1,1,1,1,0,0,1,1 (1ct 0st),1.0,
1,DR Briggs (ENG),2012-2014,6,6,1,1,0,0,1,1 (1ct 0st),0.166,
2,WC Broaster (Blz),2021-2021,1,1,1,1,0,0,1,1 (1ct 0st),1.0,
3,L Bruce (GIBR),2021-2021,9,9,1,1,0,0,1,1 (1ct 0st),0.111,
4,N Buckle (GUE),2019-2019,3,3,1,1,0,0,1,1 (1ct 0st),0.333,
5,DE Burgess (Samoa),2019-2019,4,4,1,1,0,0,1,1 (1ct 0st),0.25,
6,JA Burrows (IOM),2020-2021,5,5,1,1,0,0,1,1 (1ct 0st),0.2,
7,WAE Burton (SRB),2021-2021,4,4,1,1,0,0,1,1 (1ct 0st),0.25,
8,DK Butler (WI),2006-2006,1,1,1,1,0,0,1,1 (1ct 0st),1.0,
9,CL Cairns (NZ),2005-2006,2,2,1,1,0,0,1,1 (1ct 0st),0.5,
10,JD Campbell (WI),2019-2019,2,2,1,1,0,0,1,1 (1ct 0st),0.5,
11,RJ Campbell (HKG),2016-2016,3,3,1,1,0,0,1,1 (1ct 0st),0.333,
12,MA Carberry (ENG),2014-2014,1,1,1,1,0,0,1,1 (1ct 0st),1.0,
13,HL Carlyon (JER),2019-2021,15,15,1,1,0,0,1,1 (1ct 0st),0.066,
14,TO Carmichael (USA),2021-2021,2,2,1,1,0,0,1,1 (1ct 0st),0.5,
15,NM Carter (SCOT),2013-2013,7,7,1,1,0,0,1,1 (1ct 0st),0.142,
16,DL Chahar (INDIA),2018-2021,17,17,1,1,0,0,1,1 (1ct 0st),0.058,
17,P Chandran (Mex),2019-2019,3,3,1,1,0,0,1,1 (1ct 0st),0.333,
18,N Chejay (BHU),2019-2019,1,1,1,1,0,0,1,1 (1ct 0st),1.0,
19,TS Chisoro (ZIM),2015-2020,14,14,1,1,0,0,1,1 (1ct 0st),0.071,
20,HA Chohan (TAN),2021-2021,9,9,1,1,0,0,1,1 (1ct 0st),0.111,
21,NG Collins (Fin),2019-2021,9,9,1,1,0,0,1,1 (1ct 0st),0.111,
22,AN Cook (ENG),2007-2009,4,4,1,1,0,0,1,1 (1ct 0st),0.25,
23,J Cutinho (CRC),2019-2019,3,3,1,1,0,0,1,1 (1ct 0st),0.333,
24,DK Dahani (Iran),2020-2020,3,3,1,1,0,0,1,1 (1ct 0st),0.333,
25,DK Dahyabhai Ahir (PNM),2019-2019,2,2,1,1,0,0,1,1 (1ct 0st),0.5,
26,JWM Dalrymple (ENG),2006-2007,3,3,1,1,0,0,1,1 (1ct 0st),0.333,
27,S Dalton (CZK-R),2019-2019,2,2,1,1,0,0,1,1 (1ct 0st),0.5,
28,H Dandapani (Fin),2019-2021,7,7,1,1,0,0,1,1 (1ct 0st),0.142,
29,JC Darji (TAN),2021-2021,7,7,1,1,0,0,1,1 (1ct 0st),0.142,
30,BJ Davidson (SRB),2021-2021,4,4,1,1,0,1,0,1 (1ct 0st),0.25,
31,Dawood Ahmadzai (Fran),2021-2021,4,4,1,1,0,0,1,1 (1ct 0st),0.25,
32,AS Dean (CAN),2008-2013,2,2,1,1,0,0,1,1 (1ct 0st),0.5,
33,M de Lange (SA),2012-2015,6,6,1,1,0,0,1,1 (1ct 0st),0.166,
34,JL de Mey (NED),2021-2021,3,3,1,1,0,0,1,1 (1ct 0st),0.333,
35,SI de Saram (SL),2009-2009,1,1,1,1,0,0,1,1 (1ct 0st),1.0,
36,PC de Silva (SL),2017-2017,2,2,1,1,0,0,1,1 (1ct 0st),0.5,
37,S Desungnoen (THAI),2020-2020,2,2,1,1,0,0,1,1 (1ct 0st),0.5,
38,Dhiman Ghosh (BAN),2008-2008,1,1,1,0,1,0,0,1 (0ct 1st),1.0,
39,A Dhingra (LUX),2021-2021,3,3,1,1,0,0,1,1 (1ct 0st),0.333,
40,AB Dinda (INDIA),2009-2012,9,9,1,1,0,0,1,1 (1ct 0st),0.111,
41,M Dixit (LUX),2019-2021,10,10,1,1,0,0,1,1 (1ct 0st),0.1,
42,G Dutta (Mex),2019-2019,7,7,1,1,0,0,1,1 (1ct 0st),0.142,
43,N Dutta (CAN),2019-2019,10,10,1,1,0,0,1,1 (1ct 0st),0.1,
44,J Edness (BMUDA),2008-2008,3,3,1,0,1,0,0,1 (0ct 1st),0.333,
45,Emran Shahbakhsh (Iran),2020-2020,3,3,1,1,0,0,1,1 (1ct 0st),0.333,
46,RMS Eranga (SL),2012-2013,2,2,1,1,0,0,1,1 (1ct 0st),0.5,
47,L Evile (Samoa),2019-2019,4,4,1,1,0,0,1,1 (1ct 0st),0.25,
48,M Faheem (THAI),2019-2020,7,7,1,1,0,0,1,1 (1ct 0st),0.142,
49,Fareed Ahmad (AFG),2016-2021,16,16,1,1,0,0,1,1 (1ct 0st),0.062,
0,Farhan Ahmed (UAE),2016-2016,3,3,1,1,0,0,1,1 (1ct 0st),0.333,
1,Fayyaz Ahmed (UAE),2015-2015,1,1,1,1,0,0,1,1 (1ct 0st),1.0,
2,H Fennell (Arg),2019-2021,11,11,1,1,0,0,1,1 (1ct 0st),0.09,
3,CJ Ferguson (AUS),2009-2009,3,3,1,1,0,0,1,1 (1ct 0st),0.333,
4,B Fernando (SL),2015-2021,6,6,1,1,0,0,1,1 (1ct 0st),0.166,
5,SE Findlay (WI),2008-2008,2,2,1,1,0,0,1,1 (1ct 0st),0.5,
6,P Florin (ROM),2019-2021,16,16,1,1,0,0,1,1 (1ct 0st),0.062,
7,BT Foakes (ENG),2019-2019,1,1,1,1,0,1,0,1 (1ct 0st),1.0,
8,CR Foggo (BMUDA),2008-2008,3,3,1,1,0,0,1,1 (1ct 0st),0.333,
9,S Franklin (SUI),2021-2021,2,2,1,1,0,0,1,1 (1ct 0st),0.5,
10,TS Fray (BMUDA),2019-2019,9,9,1,1,0,0,1,1 (1ct 0st),0.111,
11,M Fru (CAM),2021-2021,4,4,1,1,0,0,1,1 (1ct 0st),0.25,
12,C Fry (LUX),2019-2019,3,3,1,1,0,0,1,1 (1ct 0st),0.333,
13,R Frylinck (SA),2017-2018,3,3,1,1,0,0,1,1 (1ct 0st),0.333,
14,ST Gabriel (WI),2013-2013,2,2,1,1,0,0,1,1 (1ct 0st),0.5,
15,RD Gaikwad (INDIA),2021-2021,2,2,1,1,0,0,1,1 (1ct 0st),0.5,
16,MD Garratt (GIBR),2019-2021,8,8,1,1,0,0,1,1 (1ct 0st),0.125,
17,Garret Banner (Blz),2019-2021,7,7,1,1,0,0,1,1 (1ct 0st),0.142,
18,WT Gavera (PNG),2015-2017,6,6,1,1,0,0,1,1 (1ct 0st),0.166,
19,Gershon Yusuf (NGA),2019-2019,1,1,1,1,0,0,1,1 (1ct 0st),1.0,
20,O Gholami (SWE),2021-2021,5,5,1,1,0,0,1,1 (1ct 0st),0.2,
21,MR Gillespie (NZ),2006-2008,11,11,1,1,0,0,1,1 (1ct 0st),0.09,
22,R Goodwin (PHI),2019-2019,3,3,1,1,0,0,1,1 (1ct 0st),0.333,
23,M Goonetilleke (MLT),2019-2021,3,3,1,1,0,0,1,1 (1ct 0st),0.333,
24,JOA Gordon (CAN),2013-2019,7,7,1,1,0,0,1,1 (1ct 0st),0.142,
25,TG Gordon (CAN),2012-2012,3,3,1,1,0,0,1,1 (1ct 0st),0.333,
26,S Goud (CZK-R),2019-2019,1,1,1,1,0,0,1,1 (1ct 0st),1.0,
27,R Gowthaman (SWE),2021-2021,5,5,1,1,0,0,1,1 (1ct 0st),0.2,
28,MS Graham (Bhm),2021-2021,6,6,1,1,0,0,1,1 (1ct 0st),0.166,
29,AM Guruge (UAE),2014-2015,5,5,1,1,0,0,1,1 (1ct 0st),0.2,
30,SP Guzman (PNM),2021-2021,5,5,1,1,0,0,1,1 (1ct 0st),0.2,
31,Hadisullah Tarakhel (Belg),2021-2021,5,5,1,1,0,0,1,1 (1ct 0st),0.2,
32,Hafez Farooq (Peru),2019-2019,4,4,1,1,0,0,1,1 (1ct 0st),0.25,
33,Hamed Khan (HKG),2020-2020,3,3,1,1,0,0,1,1 (1ct 0st),0.333,
34,Hamza Dar (ESP),2019-2021,4,4,1,1,0,0,1,1 (1ct 0st),0.25,
35,J Hansrod (),2021-2021,4,4,1,1,0,1,0,1 (1ct 0st),0.25,
36,SJ Harmison (ENG),2005-2006,2,2,1,1,0,0,1,1 (1ct 0st),0.5,
37,CV Harrison (GIBR),2021-2021,7,7,1,1,0,0,1,1 (1ct 0st),0.142,
38,Hashmatullah Shahidi (AFG),2013-2021,4,4,1,1,0,0,1,1 (1ct 0st),0.25,
39,Hassan Mehmood (SWE),2021-2021,5,5,1,1,0,0,1,1 (1ct 0st),0.2,
40,ML Hayden (AUS),2005-2007,9,9,1,1,0,0,1,1 (1ct 0st),0.111,
41,PD Hennessy (ESP),2019-2021,13,13,1,1,0,0,1,1 (1ct 0st),0.076,
42,MJ Henry (NZ),2014-2017,6,6,1,1,0,0,1,1 (1ct 0st),0.166,
43,D Heyliger (CAN),2019-2021,16,16,1,1,0,0,1,1 (1ct 0st),0.062,
44,WW Hinds (WI),2006-2010,5,5,1,1,0,0,1,1 (1ct 0st),0.2,
45,H Hiri (PNG),2016-2021,6,6,1,1,0,0,1,1 (1ct 0st),0.166,
46,GB Hogg (AUS),2006-2014,15,15,1,1,0,0,1,1 (1ct 0st),0.066,
47,IG Holland (USA),2021-2021,6,6,1,1,0,0,1,1 (1ct 0st),0.166,
48,JM How (NZ),2007-2008,5,5,1,1,0,0,1,1 (1ct 0st),0.2,
49,V Hristov (BUL),2021-2021,3,3,1,1,0,0,1,1 (1ct 0st),0.333,
0,MG Hunter (GIBR),2019-2019,4,4,1,1,0,0,1,1 (1ct 0st),0.25,
1,Husnain Kabeer (GER),2021-2021,1,1,1,1,0,1,0,1 (1ct 0st),1.0,
2,GM Hyde (Blz),2019-2019,3,3,1,1,0,0,1,1 (1ct 0st),0.333,
3,Ibrahim Nashath (Mald),2019-2021,7,7,1,1,0,0,1,1 (1ct 0st),0.142,
4,Ibrahim Zadran (AFG),2019-2019,3,3,1,1,0,0,1,1 (1ct 0st),0.333,
5,AF Ifill (Caym),2019-2019,6,6,1,1,0,0,1,1 (1ct 0st),0.166,
6,Ilyas Ahmed (KUW),2019-2020,7,7,1,1,0,0,1,1 (1ct 0st),0.142,
7,Imran Ashraf (QAT),2019-2020,4,4,1,1,0,0,1,1 (1ct 0st),0.25,
8,Imran Butt (BHR),2020-2020,4,4,1,1,0,0,1,1 (1ct 0st),0.25,
9,Imran Haider (UAE),2016-2019,11,11,1,1,0,0,1,1 (1ct 0st),0.09,
10,Imran Yousaf (Saudi),2020-2021,6,6,1,1,0,0,1,1 (1ct 0st),0.166,
11,PJ Ingram (NZ),2010-2010,3,3,1,1,0,0,1,1 (1ct 0st),0.333,
12,Iqbal Hossain (Aut),2021-2021,3,3,1,1,0,0,1,1 (1ct 0st),0.333,
13,Ishan Kishan (INDIA),2021-2021,5,5,1,0,1,0,0,1 (0ct 1st),0.2,
14,Ishtiaq Ahmad (Saudi),2021-2021,4,4,1,1,0,0,1,1 (1ct 0st),0.25,
15,KM Jadhav (INDIA),2015-2017,9,9,1,1,0,0,1,1 (1ct 0st),0.111,
16,V Jagannivasan (CZK-R),2021-2021,3,3,1,1,0,0,1,1 (1ct 0st),0.333,
17,B Jagroo (Bhm),2021-2021,4,4,1,1,0,0,1,1 (1ct 0st),0.25,
18,Jasdeep Singh (USA),2019-2019,3,3,1,1,0,0,1,1 (1ct 0st),0.333,
19,Jaweed Sadran (Aut),2021-2021,3,3,1,1,0,0,1,1 (1ct 0st),0.333,
20,M Jele (),2021-2021,4,4,1,1,0,0,1,1 (1ct 0st),0.25,
21,K Jethi (CAN),2008-2008,5,5,1,1,0,0,1,1 (1ct 0st),0.2,
22,A Johnmary (Fran),2021-2021,2,2,1,1,0,0,1,1 (1ct 0st),0.5,
23,J Jojo (DEN),2019-2019,5,5,1,1,0,0,1,1 (1ct 0st),0.2,
24,MO Jones (BMUDA),2019-2021,11,11,1,1,0,0,1,1 (1ct 0st),0.09,
25,NG Jones (IRE),2010-2012,4,4,1,1,0,0,1,1 (1ct 0st),0.25,
26,C Jonker (SA),2018-2018,2,2,1,1,0,0,1,1 (1ct 0st),0.5,
27,HJ Jordaan (THAI),2019-2020,8,8,1,1,0,0,1,1 (1ct 0st),0.125,
28,Junaid Aziz (BHR),2020-2021,7,7,1,1,0,0,1,1 (1ct 0st),0.142,
29,Junaid Siddique (BAN),2007-2012,7,7,1,1,0,0,1,1 (1ct 0st),0.142,
30,Kaleemullah (OMA),2017-2021,10,10,1,1,0,0,1,1 (1ct 0st),0.1,
31,Kaleem Shah (MOZ),2019-2019,6,6,1,1,0,0,1,1 (1ct 0st),0.166,
32,JK Kamande (KENYA),2007-2010,12,12,1,1,0,0,1,1 (1ct 0st),0.083,
33,Kamran Shazad (UAE),2014-2014,3,3,1,1,0,0,1,1 (1ct 0st),0.333,
34,TS Kamunhukamwe (ZIM),2020-2021,8,8,1,1,0,0,1,1 (1ct 0st),0.125,
35,ST Kanakalil (MLT),2020-2020,2,2,1,1,0,0,1,1 (1ct 0st),0.5,
36,TE Kane (IRE),2015-2019,5,5,1,1,0,0,1,1 (1ct 0st),0.2,
37,Kashif Daud (UAE),2021-2021,4,4,1,1,0,0,1,1 (1ct 0st),0.25,
38,S Keshvani (CAN),2010-2010,2,2,1,1,0,0,1,1 (1ct 0st),0.5,
39,RWT Key (ENG),2009-2009,1,1,1,1,0,0,1,1 (1ct 0st),1.0,
40,Khaibar Deldar (HUN),2021-2021,4,4,1,1,0,0,1,1 (1ct 0st),0.25,
41,Khizer Ahmed (NOR),2019-2019,5,5,1,0,1,0,0,1 (0ct 1st),0.2,
42,N Khosla (MLT),2019-2019,4,4,1,1,0,0,1,1 (1ct 0st),0.25,
43,Khurram Chohan (CAN),2010-2010,4,4,1,1,0,0,1,1 (1ct 0st),0.25,
44,Khurram Shahzad (QAT),2020-2020,7,7,1,1,0,0,1,1 (1ct 0st),0.142,
45,TCR Kimber (GUE),2019-2019,3,3,1,0,1,0,0,1 (0ct 1st),0.333,
46,NR Kirton (CAN),2019-2019,5,5,1,1,0,0,1,1 (1ct 0st),0.2,
47,RK Kleinveldt (SA),2008-2013,6,6,1,1,0,0,1,1 (1ct 0st),0.166,
48,D Klein (GER),2020-2021,8,8,1,1,0,0,1,1 (1ct 0st),0.125,
49,N Krishna (SEY),2021-2021,6,6,1,1,0,0,1,1 (1ct 0st),0.166,
0,P Kumar (INDIA),2008-2012,10,10,1,1,0,0,1,1 (1ct 0st),0.1,
1,R Kumar (ROM),2019-2019,4,4,1,1,0,0,1,1 (1ct 0st),0.25,
2,BLCS Kumara (CYP),2021-2021,2,2,1,1,0,0,1,1 (1ct 0st),0.5,
3,CBRLS Kumara (SL),2019-2021,13,13,1,1,0,0,1,1 (1ct 0st),0.076,
4,P Kurup (BHR),2021-2021,2,2,1,1,0,0,1,1 (1ct 0st),0.5,
5,A Lagos (GRC),2019-2019,1,1,1,1,0,0,1,1 (1ct 0st),1.0,
6,CK Langeveldt (SA),2005-2010,9,9,1,1,0,0,1,1 (1ct 0st),0.111,
7,B Laughlin (AUS),2009-2013,3,3,1,1,0,0,1,1 (1ct 0st),0.333,
8,ME Leoela (LES),2021-2021,2,2,1,1,0,0,1,1 (1ct 0st),0.5,
9,J Lewis (ENG),2005-2007,2,2,1,1,0,0,1,1 (1ct 0st),0.5,
10,ML Lewis (AUS),2006-2006,2,2,1,1,0,0,1,1 (1ct 0st),0.5,
11,RN Lewis (WI),2008-2008,1,1,1,1,0,0,1,1 (1ct 0st),1.0,
12,NCK Liyanage (MAL),2019-2019,5,5,1,1,0,0,1,1 (1ct 0st),0.2,
13,KS Lokuarachchi (SL),2012-2012,2,2,1,1,0,0,1,1 (1ct 0st),0.5,
14,J Long (PHI),2019-2019,1,1,1,1,0,0,1,1 (1ct 0st),1.0,
15,T Lungameni (NAM),2019-2021,9,9,1,1,0,0,1,1 (1ct 0st),0.111,
16,Maaz Khan (LES),2021-2021,6,6,1,1,0,0,1,1 (1ct 0st),0.166,
17,OC McCoy (WI),2019-2021,13,13,1,1,0,0,1,1 (1ct 0st),0.076,
18,GD McGrath (AUS),2005-2005,2,2,1,1,0,0,1,1 (1ct 0st),0.5,
19,NJ Maddinson (AUS),2013-2018,6,6,1,1,0,0,1,1 (1ct 0st),0.166,
20,DL Maddy (ENG),2007-2007,4,4,1,1,0,0,1,1 (1ct 0st),0.25,
21,M Magagula (),2021-2021,6,6,1,1,0,0,1,1 (1ct 0st),0.166,
22,SSB Magala (SA),2021-2021,4,4,1,1,0,0,1,1 (1ct 0st),0.25,
23,Mahmad Data (PNM),2019-2019,2,2,1,1,0,0,1,1 (1ct 0st),0.5,
24,SI Mahmood (ENG),2006-2009,4,4,1,1,0,0,1,1 (1ct 0st),0.25,
25,GI Maiden (SCOT),2008-2008,3,3,1,1,0,0,1,1 (1ct 0st),0.333,
26,BF Mailata (Samoa),2019-2019,4,4,1,1,0,0,1,1 (1ct 0st),0.25,
27,GT Main (SCOT),2015-2021,3,3,1,1,0,0,1,1 (1ct 0st),0.333,
28,A Makesh (KUW),2019-2019,4,4,1,1,0,0,1,1 (1ct 0st),0.25,
29,P Malav (LUX),2020-2021,9,9,1,1,0,0,1,1 (1ct 0st),0.111,
30,AK Mandal (NEPAL),2015-2015,2,2,1,1,0,0,1,1 (1ct 0st),0.5,
31,Mandeep Singh (INDIA),2016-2016,3,3,1,1,0,0,1,1 (1ct 0st),0.333,
32,HV Mandhyan (HUN),2021-2021,4,4,1,1,0,0,1,1 (1ct 0st),0.25,
33,P Manning (Caym),2019-2019,6,6,1,1,0,0,1,1 (1ct 0st),0.166,
34,HJH Marshall (NZ),2005-2006,3,3,1,1,0,0,1,1 (1ct 0st),0.333,
35,OM Marshall (Peru),2019-2019,3,3,1,1,0,0,1,1 (1ct 0st),0.333,
36,CS Martin (NZ),2007-2008,6,6,1,1,0,0,1,1 (1ct 0st),0.166,
37,M Martin (SUI),2021-2021,1,1,1,1,0,0,1,1 (1ct 0st),1.0,
38,DR Martyn (AUS),2005-2006,4,4,1,1,0,0,1,1 (1ct 0st),0.25,
39,I Master (BOT),2019-2019,2,2,1,1,0,0,1,1 (1ct 0st),0.5,
40,GE Mathurin (WI),2011-2012,3,3,1,1,0,0,1,1 (1ct 0st),0.333,
41,ZE Matsinhe (MOZ),2019-2021,10,10,1,1,0,0,1,1 (1ct 0st),0.1,
42,Mazharul Islam (SEY),2021-2021,6,6,1,1,0,0,1,1 (1ct 0st),0.166,
43,CE McConchie (NZ),2021-2021,5,5,1,1,0,0,1,1 (1ct 0st),0.2,
44,M Meade (Chile),2019-2019,1,1,1,1,0,0,1,1 (1ct 0st),1.0,
45,SC Meaker (ENG),2012-2012,2,2,1,1,0,0,1,1 (1ct 0st),0.5,
46,KD Mehta (CZK-R),2021-2021,3,3,1,1,0,0,1,1 (1ct 0st),0.333,
47,PHKD Mendis (SL),2018-2021,5,5,1,1,0,0,1,1 (1ct 0st),0.2,
48,CAJ Meschede (GER),2019-2019,5,5,1,1,0,0,1,1 (1ct 0st),0.2,
49,KO Meth (ZIM),2012-2012,2,2,1,1,0,0,1,1 (1ct 0st),0.5,
0,AJ Michael (Samoa),2019-2019,4,4,1,1,0,0,1,1 (1ct 0st),0.25,
1,TS Mills (ENG/ICC),2016-2022,12,12,1,1,0,0,1,1 (1ct 0st),0.083,
2,SJ Modani (USA),2021-2021,2,2,1,1,0,0,1,1 (1ct 0st),0.5,
3,K Modise (BOT),2019-2019,3,3,1,1,0,0,1,1 (1ct 0st),0.333,
4,Mohammad Irfan (PAK),2012-2019,21,21,1,1,0,0,1,1 (1ct 0st),0.047,
5,Mohammad Kashif (NED),2010-2010,3,3,1,1,0,0,1,1 (1ct 0st),0.333,
6,Mohammad Shahzad (UAE),2015-2017,20,20,1,1,0,0,1,1 (1ct 0st),0.05,
7,Mohammad Tauqir (UAE),2015-2015,3,3,1,1,0,0,1,1 (1ct 0st),0.333,
8,Mohammad Yousuf (PAK),2006-2010,3,3,1,1,0,0,1,1 (1ct 0st),0.333,
9,JN Mohammed (WI),2017-2018,9,9,1,1,0,0,1,1 (1ct 0st),0.111,
10,Mohammed Qasim (UAE),2016-2017,3,3,1,1,0,0,1,1 (1ct 0st),0.333,
11,Mohammed Shami (INDIA),2014-2021,16,16,1,1,0,0,1,1 (1ct 0st),0.062,
12,Mohammed Siraj (INDIA),2017-2021,4,4,1,1,0,0,1,1 (1ct 0st),0.25,
13,SA Mohandas (HUN),2021-2021,3,3,1,1,0,0,1,1 (1ct 0st),0.333,
14,HJC Mol (NED),2008-2008,3,3,1,1,0,0,1,1 (1ct 0st),0.333,
15,Mominul Haque (BAN),2012-2014,6,6,1,1,0,0,1,1 (1ct 0st),0.166,
16,D Mongia (INDIA),2006-2006,1,1,1,1,0,0,1,1 (1ct 0st),1.0,
17,KV Morea (PNG),2021-2021,4,4,1,1,0,0,1,1 (1ct 0st),0.25,
18,S Movva (CAN),2021-2021,1,1,1,1,0,1,0,1 (1ct 0st),1.0,
19,G Mubiru (UGA),2021-2021,3,3,1,1,0,0,1,1 (1ct 0st),0.333,
20,Mudassar Muhammad (GER),2019-2019,7,7,1,1,0,0,1,1 (1ct 0st),0.142,
21,Muhamad Syahadat (MAL),2019-2019,9,9,1,1,0,0,1,1 (1ct 0st),0.111,
22,Muhammad Amin (),2021-2021,6,6,1,1,0,0,1,1 (1ct 0st),0.166,
23,Muhammad Amir (MAL),2019-2019,1,1,1,1,0,0,1,1 (1ct 0st),1.0,
24,Muhammad Asjed (ESP),2019-2021,3,3,1,1,0,0,1,1 (1ct 0st),0.333,
25,Muhammad Kaleem (UAE),2016-2016,9,9,1,1,0,0,1,1 (1ct 0st),0.111,
26,Muhammad Khurram (MWI),2019-2019,5,5,1,1,0,1,0,1 (1ct 0st),0.2,
27,Muhammad Muneeb (Belg),2020-2021,7,7,1,1,0,0,1,1 (1ct 0st),0.142,
28,Muhammad Murad (QAT),2021-2021,4,4,1,1,0,0,1,1 (1ct 0st),0.25,
29,Muhammad Naeem (Saudi),2019-2020,7,7,1,1,0,0,1,1 (1ct 0st),0.142,
30,Muhammad Saleem (),2019-2019,4,4,1,1,0,0,1,1 (1ct 0st),0.25,
31,Muhammad Wafiq (MAL),2019-2021,7,7,1,1,0,0,1,1 (1ct 0st),0.142,
32,JK Mukhiya (NEPAL),2014-2015,4,4,1,1,0,0,1,1 (1ct 0st),0.25,
33,EMDY Munaweera (SL),2012-2017,12,12,1,1,0,0,1,1 (1ct 0st),0.083,
34,Munir Dar (HKG),2014-2014,2,2,1,1,0,0,1,1 (1ct 0st),0.5,
35,M Muralitharan (SL),2006-2010,12,12,1,1,0,0,1,1 (1ct 0st),0.083,
36,D Murphy (SCOT),2013-2013,4,4,1,1,0,1,0,1 (1ct 0st),0.25,
37,Murtaza Yamin (CYP),2021-2021,1,1,1,1,0,0,1,1 (1ct 0st),1.0,
38,N M'shangwe (ZIM),2013-2014,5,5,1,1,0,0,1,1 (1ct 0st),0.2,
39,Mustafa Omer (Fran),2021-2021,1,1,1,1,0,0,1,1 (1ct 0st),1.0,
40,T Muzarabani (ZIM),2015-2016,9,9,1,1,0,0,1,1 (1ct 0st),0.111,
41,L Nakomo (MWI),2021-2021,6,6,1,1,0,0,1,1 (1ct 0st),0.166,
42,W Nalisa (VAN),2019-2019,9,9,1,1,0,0,1,1 (1ct 0st),0.111,
43,DP Nannes (AUS/NED),2009-2010,16,16,1,1,0,0,1,1 (1ct 0st),0.062,
44,Naveed Fakhr (KUW),2020-2021,3,3,1,1,0,0,1,1 (1ct 0st),0.333,
45,Naveed Shahid (Fin),2021-2021,4,4,1,1,0,0,1,1 (1ct 0st),0.25,
46,Nazakat Ali (NOR),2019-2019,2,2,1,1,0,0,1,1 (1ct 0st),0.5,
47,A Nel (SA),2005-2007,2,2,1,1,0,0,1,1 (1ct 0st),0.5,
48,JD Nel (SCOT),2007-2010,9,9,1,1,0,0,1,1 (1ct 0st),0.111,
49,B Niaz (Belg),2021-2021,7,7,1,1,0,0,1,1 (1ct 0st),0.142,
0,R Nil (SEY),2021-2021,4,4,1,1,0,0,1,1 (1ct 0st),0.25,
1,PA Nixon (ENG),2007-2007,1,1,1,0,1,0,0,1 (0ct 1st),1.0,
2,Nooruddin Mujadady (GER),2021-2021,5,5,1,1,0,0,1,1 (1ct 0st),0.2,
3,L Nussbaumer (GUE),2019-2019,1,1,1,1,0,0,1,1 (1ct 0st),1.0,
4,SH Obed (VAN),2019-2019,12,12,1,1,0,0,1,1 (1ct 0st),0.083,
5,O Harvey (Ghana),2021-2021,11,11,1,1,0,0,1,1 (1ct 0st),0.09,
6,PP Ojha (INDIA),2009-2010,6,6,1,1,0,0,1,1 (1ct 0st),0.166,
7,SNJ O'Keefe (AUS),2010-2011,7,7,1,1,0,0,1,1 (1ct 0st),0.142,
8,SO Olayinka (NGA),2021-2021,3,3,1,1,0,0,1,1 (1ct 0st),0.333,
9,R Olipa (UGA),2019-2019,2,2,1,1,0,0,1,1 (1ct 0st),0.5,
10,SD Outerbridge (BMUDA),2008-2008,3,3,1,1,0,0,1,1 (1ct 0st),0.333,
11,BA Pai (GIBR),2019-2021,9,9,1,1,0,0,1,1 (1ct 0st),0.111,
12,K Pala (PNG),2015-2015,2,2,1,1,0,0,1,1 (1ct 0st),0.5,
13,I Pandey (NEPAL),2019-2019,4,4,1,1,0,0,1,1 (1ct 0st),0.25,
14,NMS Param (SGP),2019-2019,8,8,1,1,0,0,1,1 (1ct 0st),0.125,
15,HV Patel (INDIA),2021-2021,2,2,1,1,0,0,1,1 (1ct 0st),0.5,
16,PA Patel (INDIA),2011-2011,2,2,1,1,0,1,0,1 (1ct 0st),0.5,
17,D Paterson (SA),2017-2018,8,8,1,1,0,0,1,1 (1ct 0st),0.125,
18,C Pengkumta (THAI),2019-2020,5,5,1,1,0,0,1,1 (1ct 0st),0.2,
19,AK Perera (SL),2013-2019,6,6,1,1,0,0,1,1 (1ct 0st),0.166,
20,SL Perera (Ghana),2019-2019,2,2,1,1,0,0,1,1 (1ct 0st),0.5,
21,WKD Perkins (WI),2008-2008,1,1,1,1,0,0,1,1 (1ct 0st),1.0,
22,J Perman (ESP),2019-2021,7,7,1,1,0,0,1,1 (1ct 0st),0.142,
23,C Pervez (CAN),2021-2021,5,5,1,1,0,0,1,1 (1ct 0st),0.2,
24,AN Petersen (SA),2010-2010,2,2,1,1,0,0,1,1 (1ct 0st),0.5,
25,VD Philander (SA),2007-2007,7,7,1,1,0,0,1,1 (1ct 0st),0.142,
26,K Pierre (WI),2018-2020,9,9,1,1,0,0,1,1 (1ct 0st),0.111,
27,R Pillai (GER),2019-2019,6,6,1,1,0,0,1,1 (1ct 0st),0.166,
28,R Pisal (ROM),2019-2019,1,1,1,1,0,0,1,1 (1ct 0st),1.0,
29,S Pokhriyal (CZK-R),2019-2020,9,9,1,1,0,0,1,1 (1ct 0st),0.111,
30,KOA Powell (WI),2014-2014,1,1,1,1,0,0,1,1 (1ct 0st),1.0,
31,D Pretorius (SA),2017-2021,22,22,1,1,0,0,1,1 (1ct 0st),0.045,
32,M Pushpakumara (SL),2009-2009,1,1,1,1,0,0,1,1 (1ct 0st),1.0,
33,Qudratullah Mir Afzail (SWE),2021-2021,6,6,1,1,0,0,1,1 (1ct 0st),0.166,
34,Moshiur Rahman (EST),2021-2021,3,3,1,1,0,0,1,1 (1ct 0st),0.333,
35,Rahmatullah Mangal (Fran),2021-2021,4,4,1,1,0,0,1,1 (1ct 0st),0.25,
36,A Rangaswamy (BOT),2019-2021,8,8,1,1,0,0,1,1 (1ct 0st),0.125,
37,Raqibul Hasan (BAN),2008-2010,5,5,1,1,0,0,1,1 (1ct 0st),0.2,
38,Ravinder Singh (MLT),2019-2021,6,6,1,1,0,0,1,1 (1ct 0st),0.166,
39,CMW Read (ENG),2006-2006,1,1,1,1,0,1,0,1 (1ct 0st),1.0,
40,FL Reifer (WI),2009-2009,1,1,1,1,0,0,1,1 (1ct 0st),1.0,
41,CP Rizwan (UAE),2019-2021,6,6,1,1,0,0,1,1 (1ct 0st),0.166,
42,KAJ Roach (WI),2008-2012,11,11,1,1,0,0,1,1 (1ct 0st),0.09,
43,IH Romaine (BMUDA),2008-2008,2,2,1,1,0,0,1,1 (1ct 0st),0.5,
44,Rubel Hossain (BAN),2009-2021,27,27,1,1,0,0,1,1 (1ct 0st),0.037,
45,Rumman Raees (PAK),2016-2018,8,8,1,1,0,0,1,1 (1ct 0st),0.125,
46,RJMGM Rupasinghe (SL),2009-2009,2,2,1,1,0,0,1,1 (1ct 0st),0.5,
47,GR Russ (PHI),2019-2019,3,3,1,1,0,0,1,1 (1ct 0st),0.333,
48,HD Rutherford (NZ),2013-2019,7,7,1,1,0,0,1,1 (1ct 0st),0.142,
49,SE Rutherford (WI),2018-2020,5,5,1,1,0,0,1,1 (1ct 0st),0.2,
0,Saad Nasim (PAK),2014-2014,3,3,1,1,0,0,1,1 (1ct 0st),0.333,
1,VM Sachdev (PNM),2019-2019,2,2,1,1,0,0,1,1 (1ct 0st),0.5,
2,Sadeeq Khan (ROM),2019-2019,3,3,1,1,0,0,1,1 (1ct 0st),0.333,
3,Said Hakim (Belg),2021-2021,1,1,1,1,0,0,1,1 (1ct 0st),1.0,
4,Saif Hassan (BAN),2021-2021,2,2,1,1,0,0,1,1 (1ct 0st),0.5,
5,Sajedul Islam (BAN),2013-2013,1,1,1,1,0,0,1,1 (1ct 0st),1.0,
6,AM Samad (CAN),2008-2010,7,7,1,1,0,0,1,1 (1ct 0st),0.142,
7,Samir Patel (LES),2021-2021,6,6,1,1,0,0,1,1 (1ct 0st),0.166,
8,JRMVB Sanjaya (SL),2017-2017,8,8,1,1,0,0,1,1 (1ct 0st),0.125,
9,S Santhirakumaran (Fran),2021-2021,3,3,1,1,0,0,1,1 (1ct 0st),0.333,
10,K Santokie (WI),2011-2014,11,11,1,1,0,0,1,1 (1ct 0st),0.09,
11,Saqlain Ali (Belg),2019-2021,6,6,1,1,0,0,1,1 (1ct 0st),0.166,
12,Saqlain Arshad (QAT),2019-2019,2,2,1,1,0,0,1,1 (1ct 0st),0.5,
13,M Sarenac (SRB),2019-2021,6,6,1,1,0,0,1,1 (1ct 0st),0.166,
14,Sarfaraj Patel (LES),2021-2021,6,6,1,1,0,0,1,1 (1ct 0st),0.166,
15,MM Sarwar (KUW),2019-2021,7,7,1,1,0,0,1,1 (1ct 0st),0.142,
16,I Sawmy (DEN),2019-2019,2,2,1,1,0,0,1,1 (1ct 0st),0.5,
17,Sayed Shirzad (AFG),2015-2019,4,4,1,1,0,0,1,1 (1ct 0st),0.25,
18,CP Schofield (ENG),2007-2007,4,4,1,1,0,0,1,1 (1ct 0st),0.25,
19,BV Sears (NZ),2021-2021,2,2,1,1,0,0,1,1 (1ct 0st),0.5,
20,J Sebanja (UGA),2021-2021,2,2,1,1,0,0,1,1 (1ct 0st),0.5,
21,E Sebareme (RWN),2021-2021,6,6,1,1,0,0,1,1 (1ct 0st),0.166,
22,L Shafeeg (Mald),2019-2021,8,8,1,1,0,0,1,1 (1ct 0st),0.125,
23,Shaffeq Muhammad (GRC),2019-2019,2,2,1,1,0,0,1,1 (1ct 0st),0.5,
24,Shafiul Islam (BAN),2010-2020,20,20,1,1,0,0,1,1 (1ct 0st),0.05,
25,Shahab Alam (NEPAL),2021-2021,3,3,1,1,0,0,1,1 (1ct 0st),0.333,
26,Shahriar Nafees (BAN),2006-2006,1,1,1,1,0,0,1,1 (1ct 0st),1.0,
27,A Shahzad (ENG),2010-2011,3,3,1,1,0,0,1,1 (1ct 0st),0.333,
28,Shamsudheen Purat (Saudi),2019-2020,6,6,1,1,0,0,1,1 (1ct 0st),0.166,
29,JNK Shannon (IRE),2013-2018,8,8,1,1,0,0,1,1 (1ct 0st),0.125,
30,Sharafuddin Ashraf (AFG),2015-2021,10,10,1,1,0,0,1,1 (1ct 0st),0.1,
31,MM Sharma (INDIA),2014-2015,8,8,1,1,0,0,1,1 (1ct 0st),0.125,
32,PP Shaw (INDIA),2021-2021,1,1,1,1,0,0,1,1 (1ct 0st),1.0,
33,Shehzad Patel (),2021-2021,6,6,1,1,0,1,0,1 (1ct 0st),0.166,
34,V Shetty (UAE),2014-2014,2,2,1,1,0,0,1,1 (1ct 0st),0.5,
35,Shoaib Khan jnr (PAK),2008-2008,4,4,1,1,0,0,1,1 (1ct 0st),0.25,
36,Shuvagata Hom (BAN),2016-2016,5,5,1,1,0,0,1,1 (1ct 0st),0.2,
37,EHSN Silva (UAE),2014-2014,2,2,1,1,0,0,1,1 (1ct 0st),0.5,
38,KRP Silva (USA),2019-2019,1,1,1,1,0,0,1,1 (1ct 0st),1.0,
39,LA Simango (MOZ),2019-2021,7,7,1,1,0,0,1,1 (1ct 0st),0.142,
40,G Singh (USA),2021-2021,6,6,1,1,0,0,1,1 (1ct 0st),0.166,
41,J Singye (BHU),2019-2019,2,2,1,1,0,0,1,1 (1ct 0st),0.5,
42,DS Smith (WI),2007-2009,6,6,1,1,0,0,1,1 (1ct 0st),0.166,
43,SJS Smith (SCOT),2010-2012,5,5,1,0,1,0,0,1 (0ct 1st),0.2,
44,J Smits (NED),2008-2009,5,5,1,1,0,1,0,1 (1ct 0st),0.2,
45,JT Smuts (SA),2017-2021,13,13,1,1,0,0,1,1 (1ct 0st),0.076,
46,JN Snape (ENG),2007-2007,1,1,1,1,0,0,1,1 (1ct 0st),1.0,
47,GJ Snyman (SA),2021-2021,1,1,1,1,0,0,1,1 (1ct 0st),1.0,
48,CB Sole (SCOT),2017-2021,7,7,1,1,0,0,1,1 (1ct 0st),0.142,
49,GO Sopinho (MOZ),2021-2021,1,1,1,1,0,0,1,1 (1ct 0st),1.0,
0,A Srivastav (Chile),2019-2019,4,4,1,1,0,0,1,1 (1ct 0st),0.25,
1,G Stewart (ITA),2021-2021,6,6,1,1,0,0,1,1 (1ct 0st),0.166,
2,ACF Stokes (GUE),2019-2020,7,7,1,1,0,0,1,1 (1ct 0st),0.142,
3,ADL Stokoe (IOM),2021-2021,4,4,1,1,0,0,1,1 (1ct 0st),0.25,
4,AJ Strauss (ENG),2005-2009,4,4,1,1,0,0,1,1 (1ct 0st),0.25,
5,R Strydom (IRE),2008-2008,3,3,1,1,0,0,1,1 (1ct 0st),0.333,
6,Sufyan Mehmood (OMA),2015-2020,4,4,1,1,0,0,1,1 (1ct 0st),0.25,
7,P Syafiq Ali (MAL),2019-2019,1,1,1,1,0,0,1,1 (1ct 0st),1.0,
8,Syed Rasel (BAN),2007-2008,8,8,1,1,0,0,1,1 (1ct 0st),0.125,
9,Talha Khan (GER),2019-2021,13,13,1,1,0,0,1,1 (1ct 0st),0.076,
10,Tanveer Ahmed (HKG),2016-2017,5,5,1,1,0,0,1,1 (1ct 0st),0.2,
11,T Taylor (Caym),2019-2019,6,6,1,1,0,0,1,1 (1ct 0st),0.166,
12,SR Tendulkar (INDIA),2006-2006,1,1,1,1,0,0,1,1 (1ct 0st),1.0,
13,SP Terry (IRE),2016-2016,1,1,1,1,0,0,1,1 (1ct 0st),1.0,
14,S Thanikaithasan (DEN),2021-2021,6,6,1,1,0,0,1,1 (1ct 0st),0.166,
15,DC Thomas (WI),2009-2021,4,4,1,0,1,0,0,1 (0ct 1st),0.25,
16,O Thomas (WI),2018-2021,19,19,1,1,0,0,1,1 (1ct 0st),0.052,
17,BM Tickner (NZ),2019-2021,8,8,1,1,0,0,1,1 (1ct 0st),0.125,
18,S Tobgay (BHU),2019-2019,2,2,1,1,0,0,1,1 (1ct 0st),0.5,
19,GC Tonge (WI),2009-2009,1,1,1,1,0,0,1,1 (1ct 0st),1.0,
20,RJW Topley (ENG),2015-2022,10,10,1,1,0,0,1,1 (1ct 0st),0.1,
21,S Tosic (SRB),2021-2021,4,4,1,1,0,0,1,1 (1ct 0st),0.25,
22,A Tripathi (Mex),2019-2019,3,3,1,1,0,0,1,1 (1ct 0st),0.333,
23,R Trumpelmann (NAM),2021-2021,10,10,1,1,0,0,1,1 (1ct 0st),0.1,
24,LL Tsotsobe (SA),2009-2014,23,23,1,1,0,0,1,1 (1ct 0st),0.043,
25,JJ Tucker (BMUDA),2019-2019,5,5,1,1,0,0,1,1 (1ct 0st),0.2,
26,B Tuyizere (RWN),2021-2021,10,10,1,1,0,0,1,1 (1ct 0st),0.1,
27,S Tyagi (INDIA),2009-2009,1,1,1,1,0,0,1,1 (1ct 0st),1.0,
28,S Udhayan (SEY),2021-2021,5,5,1,1,0,0,1,1 (1ct 0st),0.2,
29,W Uisuk (THAI),2020-2020,4,4,1,1,0,0,1,1 (1ct 0st),0.25,
30,Umair Qasim (),2021-2021,6,6,1,1,0,0,1,1 (1ct 0st),0.166,
31,A Uniyal (Chile),2019-2019,3,3,1,1,0,0,1,1 (1ct 0st),0.333,
32,Usman Ali (Saudi),2019-2020,8,8,1,1,0,0,1,1 (1ct 0st),0.125,
33,Usman Khan (Fran),2021-2021,4,4,1,1,0,0,1,1 (1ct 0st),0.25,
34,Usman Limbada (CAN),2010-2013,7,7,1,1,0,0,1,1 (1ct 0st),0.142,
35,Usman Shinwari (PAK),2013-2019,16,16,1,1,0,0,1,1 (1ct 0st),0.062,
36,Usman Waheed (KUW),2019-2019,6,6,1,1,0,0,1,1 (1ct 0st),0.166,
37,PJ van Biljon (SA),2020-2021,10,10,1,1,0,0,1,1 (1ct 0st),0.1,
38,JDF Vandersay (SL),2015-2019,10,10,1,1,0,0,1,1 (1ct 0st),0.1,
39,MB van Schelven (NED),2015-2015,2,2,1,1,0,0,1,1 (1ct 0st),0.5,
40,TCW Veillard (GUE),2019-2019,4,4,1,1,0,0,1,1 (1ct 0st),0.25,
41,S Vijayakumar (SGP),2019-2019,9,9,1,1,0,0,1,1 (1ct 0st),0.111,
42,V Vijh (LUX),2019-2021,16,16,1,1,0,0,1,1 (1ct 0st),0.062,
43,Vimal Kumar (PHI),2019-2019,1,1,1,1,0,0,1,1 (1ct 0st),1.0,
44,R Vinay Kumar (INDIA),2010-2013,9,9,1,1,0,0,1,1 (1ct 0st),0.111,
45,Vinay Ravi (NOR),2021-2021,5,5,1,1,0,0,1,1 (1ct 0st),0.2,
46,L Vincent (NZ),2006-2007,9,9,1,1,0,0,1,1 (1ct 0st),0.111,
47,W Viraliliu (VAN),2019-2019,10,10,1,1,0,0,1,1 (1ct 0st),0.1,
48,Virk Ali (Fran),2021-2021,4,4,1,1,0,0,1,1 (1ct 0st),0.25,
49,Vishal Ahir (PNM),2019-2019,1,1,1,1,0,0,1,1 (1ct 0st),1.0,
0,K Vislapuu (EST),2021-2021,5,5,1,1,0,0,1,1 (1ct 0st),0.2,
1,KDK Vithanage (SL),2014-2016,3,3,1,1,0,0,1,1 (1ct 0st),0.333,
2,DS Vosloo (MLT),2021-2021,2,2,1,1,0,0,1,1 (1ct 0st),0.5,
3,Vraj Patel (KENYA),2021-2021,8,8,1,1,0,0,1,1 (1ct 0st),0.125,
4,Wahidullah Usmani (Belg),2020-2021,7,7,1,1,0,0,1,1 (1ct 0st),0.142,
5,Waqar Abbasi (ROM),2020-2021,3,3,1,1,0,0,1,1 (1ct 0st),0.333,
6,Waqar Khan (Peru),2019-2019,4,4,1,1,0,0,1,1 (1ct 0st),0.25,
7,Waqar Zalmai (Aut),2021-2021,1,1,1,1,0,0,1,1 (1ct 0st),1.0,
8,S Waqas Ahmed (NOR),2019-2021,10,10,1,1,0,0,1,1 (1ct 0st),0.1,
9,Waqas Ali (Belg),2019-2019,2,2,1,1,0,0,1,1 (1ct 0st),0.5,
10,Waqas Khan (HKG),2014-2020,16,16,1,1,0,0,1,1 (1ct 0st),0.062,
11,VS Wategaonkar (OMA),2016-2016,2,2,1,1,0,0,1,1 (1ct 0st),0.5,
12,RM West (IRE),2009-2009,5,5,1,1,0,0,1,1 (1ct 0st),0.2,
13,AA Westphal (Mex),2019-2019,5,5,1,1,0,0,1,1 (1ct 0st),0.2,
14,BM Wheeler (NZ),2017-2018,6,6,1,1,0,0,1,1 (1ct 0st),0.166,
15,SA Wijeyeratne (CAN),2019-2019,2,2,1,1,0,0,1,1 (1ct 0st),0.5,
16,JD Wildermuth (AUS),2018-2018,2,2,1,1,0,0,1,1 (1ct 0st),0.5,
17,S Williams (SLE),2021-2021,10,10,1,1,0,0,1,1 (1ct 0st),0.1,
18,LJ Woodcock (NZ),2010-2011,3,3,1,1,0,0,1,1 (1ct 0st),0.333,
19,GH Worker (NZ),2015-2015,2,2,1,1,0,0,1,1 (1ct 0st),0.5,
20,AS Wright (GUE),2019-2019,7,7,1,1,0,0,1,1 (1ct 0st),0.142,
21,CM Wright (SCOT),2007-2009,2,2,1,1,0,0,1,1 (1ct 0st),0.5,
22,JJ Wright (),2021-2021,5,5,1,1,0,0,1,1 (1ct 0st),0.2,
23,HN Ya France (NAM),2019-2021,13,13,1,1,0,0,1,1 (1ct 0st),0.076,
24,Yasar Idrees (KUW),2019-2019,1,1,1,1,0,0,1,1 (1ct 0st),1.0,
25,Yasir Arafat (PAK),2007-2012,13,13,1,1,0,0,1,1 (1ct 0st),0.076,
26,Yasir Mohammad (USA),2021-2021,2,2,1,1,0,0,1,1 (1ct 0st),0.5,
27,Zaheer Maqsood (UAE),2015-2016,3,3,1,1,0,0,1,1 (1ct 0st),0.333,
28,Zahid Hussain (CAN),2012-2012,3,3,1,1,0,0,1,1 (1ct 0st),0.333,
29,Zahir Mohammed (HUN),2021-2021,4,4,1,1,0,0,1,1 (1ct 0st),0.25,
30,Zawar Farid (UAE),2019-2019,4,4,1,1,0,0,1,1 (1ct 0st),0.25,
31,Zeeshan Abbas (BHR),2019-2019,1,1,1,1,0,0,1,1 (1ct 0st),1.0,
32,V Zimonjic (SRB),2021-2021,4,4,1,1,0,0,1,1 (1ct 0st),0.25,
33,Zoheb Malek (MLT),2021-2021,1,1,1,1,0,0,1,1 (1ct 0st),1.0,
34,Zubaidi Zulkifle (MAL),2019-2019,4,4,1,1,0,0,1,1 (1ct 0st),0.25,
35,Zulfiqar Babar (PAK),2013-2014,7,7,1,1,0,0,1,1 (1ct 0st),0.142,
36,Zulqarnain Haider (PAK),2007-2010,3,3,1,0,1,0,0,1 (0ct 1st),0.333,
37,Zulqarnain Haider (ESP),2019-2019,5,5,1,1,0,0,1,1 (1ct 0st),0.2,
38,ME Sanuth (OMA),2020-2020,1,1,0,0,0,0,0,0,0.0,
39,Aamer Ikram (PORT),2019-2019,4,4,0,0,0,0,0,0,0.0,
40,Aamer Yamin (PAK),2015-2018,2,2,0,0,0,0,0,0,0.0,
41,P Abanda (CAM),2021-2021,4,4,0,0,0,0,0,0,0.0,
42,Z Abbasi (BOT),2019-2019,1,1,0,0,0,0,0,0,0.0,
43,Abbas Saad (Saudi),2019-2019,2,2,0,0,0,0,0,0,0.0,
44,YA Abdulla (SA),2009-2009,2,2,0,0,0,0,0,0,0.0,
45,Abdullah Jasat (PNM),2021-2021,6,6,0,0,0,0,0,0,0.0,
46,Abdullah Mahmood (DEN),2019-2019,1,1,0,0,0,0,0,0,0.0,
47,Abdullah Shafique (PAK),2020-2020,3,3,0,0,0,0,0,0,0.0,
48,Abdullah Sheikh (NOR),2019-2019,2,2,0,0,0,0,0,0,0.0,
49,Abdul Majid (BHR),2020-2021,6,6,0,0,0,0,0,0,0.0,
0,Abdul Rahman (Aut),2019-2019,3,3,0,0,0,0,0,0,0.0,
1,Abdul Rashid (Belg),2019-2021,2,2,0,0,0,0,0,0,0.0,
2,Abdur Rauf (PAK),2008-2008,1,1,0,0,0,0,0,0,0.0,
3,JB Abega (CAM),2021-2021,4,4,0,0,0,0,0,0,0.0,
4,Abhijeet Ahuja (HUN),2021-2021,4,4,0,0,0,0,0,0,0.0,
5,M Aboagye (Ghana),2019-2019,3,3,0,0,0,0,0,0,0.0,
6,Abul Hasan (BAN),2012-2018,5,5,0,0,0,0,0,0,0.0,
7,Adel Kolasangiani (Iran),2020-2020,1,1,0,0,0,0,0,0,0.0,
8,Adil Hanif (BHR),2019-2019,4,4,0,0,0,0,0,0,0.0,
9,Adnan Mufti (UAE),2017-2017,1,1,0,0,0,0,0,0,0.0,
10,Adnan Razzaq (Belg),2021-2021,1,1,0,0,0,0,0,0,0.0,
11,Adnan Syed (Fin),2021-2021,2,2,0,0,0,0,0,0,0.0,
12,N Advani (GIBR),2019-2019,1,1,0,0,0,0,0,0,0.0,
13,Aftab Ahmed (2) (DEN),2019-2021,4,4,0,0,0,0,0,0,0.0,
14,R Agamiire (UGA),2021-2021,2,2,0,0,0,0,0,0,0.0,
15,AB Agarkar (INDIA),2006-2007,3,3,0,0,0,0,0,0,0.0,
16,A Ahmadhel (BUL),2019-2021,9,9,0,0,0,0,0,0,0.0,
17,Ahmadullah Shinwari (NOR),2021-2021,1,1,0,0,0,0,0,0,0.0,
18,RI Ahmed (NED),2015-2015,2,2,0,0,0,0,0,0,0.0,
19,Ahmed Raid (Mald),2020-2020,1,1,0,0,0,0,0,0,0.0,
20,Ahmed Wardak (GER),2019-2020,10,10,0,0,0,0,0,0,0.0,
21,Ahsan Abbasi (HKG),2019-2019,6,6,0,0,0,0,0,0,0.0,
22,Ahsan Ali (PAK),2020-2020,2,2,0,0,0,0,0,0,0.0,
23,Ahsan Khan (BUL),2021-2021,4,4,0,0,0,0,0,0,0.0,
24,Ainool Hafizs (MAL),2019-2021,4,4,0,0,0,0,0,0,0.0,
25,KS Airee (NEPAL),2021-2021,2,2,0,0,0,0,0,0,0.0,
26,Aizaz Cheema (PAK),2011-2012,5,5,0,0,0,0,0,0,0.0,
27,D Ajekun (NGA),2019-2021,11,11,0,0,0,0,0,0,0.0,
28,NN Akhter (MLT),2020-2020,2,2,0,0,0,0,0,0,0.0,
29,C Akyuz (TKY),2019-2019,1,1,0,0,0,0,0,0,0.0,
30,Ali Ivan (Mald),2019-2019,1,1,0,0,0,0,0,0,0.0,
31,Ali Abbas (Saudi),2020-2020,1,1,0,0,0,0,0,0,0.0,
32,Ali Naqi (PORT),2019-2019,4,4,0,0,0,0,0,0,0.0,
33,Ali Mohammadipour (Iran),2020-2020,3,3,0,0,0,0,0,0,0.0,
34,Ali Yalmaz (HUN),2021-2021,4,4,0,0,0,0,0,0,0.0,
35,J Allen (),2019-2019,2,2,0,0,0,0,0,0,0.0,
36,HS Alta (TKY),2019-2019,4,4,0,0,0,0,0,0,0.0,
37,Ameel Mauroof (Mald),2019-2021,14,14,0,0,0,0,0,0,0.0,
38,Ameer Saiyed (BOT),2019-2019,4,4,0,0,0,0,0,0,0.0,
39,Amir Hayat (UAE),2018-2019,4,4,0,0,0,0,0,0,0.0,
40,Amir Shahzad (Saudi),2021-2021,1,1,0,0,0,0,0,0,0.0,
41,Ammad Uddin (BHR),2019-2021,12,12,0,0,0,0,0,0,0.0,
42,Aanand Pandey (LUX),2021-2021,3,3,0,0,0,0,0,0,0.0,
43,Anas Khan (HKG),2014-2014,1,1,0,0,0,0,0,0,0.0,
44,J Anderson (IRE),2015-2015,2,2,0,0,0,0,0,0,0.0,
45,Andrey Lilov (BUL),2021-2021,4,4,0,0,0,0,0,0,0.0,
46,A Anemogiannis (GRC),2019-2019,1,1,0,0,0,0,0,0,0.0,
47,B Angeltti (Arg),2019-2021,4,4,0,0,0,0,0,0,0.0,
48,DNA Ankrah (Ghana),2019-2019,4,4,0,0,0,0,0,0,0.0,
49,M Ansari (OMA),2015-2016,10,10,0,0,0,0,0,0,0.0,
0,Ansar Iqbal (NOR),2019-2019,4,4,0,0,0,0,0,0,0.0,
1,Anser Mehmood (SUI),2021-2021,4,4,0,0,0,0,0,0,0.0,
2,MA Aponso (SL),2018-2018,3,3,0,0,0,0,0,0,0.0,
3,Apon Mustafizur (SRB),2019-2021,4,4,0,0,0,0,0,0,0.0,
4,S Appu (MLT),2019-2019,4,4,0,0,0,0,0,0,0.0,
5,S Aravind (INDIA),2015-2015,1,1,0,0,0,0,0,0,0.0,
6,Z Arinaitwe (UGA),2019-2020,6,6,0,0,0,0,0,0,0.0,
7,RP Arnold (SL),2006-2006,1,1,0,0,0,0,0,0,0.0,
8,Arsalan Qadir (CAN),2010-2010,1,1,0,0,0,0,0,0,0.0,
9,Arshad Hayat (CZK-R),2019-2019,7,7,0,0,0,0,0,0,0.0,
10,Arshad Iqbal (PAK),2021-2021,1,1,0,0,0,0,0,0,0.0,
11,Arslan Ahmed (PORT),2019-2019,3,3,0,0,0,0,0,0,0.0,
12,Asad Ali (PAK),2013-2013,2,2,0,0,0,0,0,0,0.0,
13,Asad Mahmood (SUI),2021-2021,4,4,0,0,0,0,0,0,0.0,
14,Ashish Rana (EST),2021-2021,4,4,0,0,0,0,0,0,0.0,
15,Ashraful Shuvo (EST),2021-2021,3,3,0,0,0,0,0,0,0.0,
16,Ashwin Vinod (SUI),2021-2021,4,4,0,0,0,0,0,0,0.0,
17,Imran Asif (Aut),2021-2021,3,3,0,0,0,0,0,0,0.0,
18,Asif Bevinje (ROM),2020-2021,6,6,0,0,0,0,0,0,0.0,
19,Aslam Doria (PNM),2021-2021,3,3,0,0,0,0,0,0,0.0,
20,A Aspiotis (GRC),2019-2019,3,3,0,0,0,0,0,0,0.0,
21,Aswad Khan (BUL),2021-2021,2,2,0,0,0,0,0,0,0.0,
22,MS Atapattu (SL),2006-2006,2,2,0,0,0,0,0,0,0.0,
23,S Ateak (Ghana),2019-2019,3,3,0,0,0,0,0,0,0.0,
24,Atif Ali Khan (UAE),2016-2016,1,1,0,0,0,0,0,0,0.0,
25,Atif Mehmood (ESP),2019-2021,12,12,0,0,0,0,0,0,0.0,
26,R Avery (),2019-2019,4,4,0,0,0,0,0,0,0.0,
27,Awais Zia (PAK),2012-2014,5,5,0,0,0,0,0,0,0.0,
28,P Awana (INDIA),2012-2012,2,2,0,0,0,0,0,0,0.0,
29,Ayush Ummat (EST),2021-2021,1,1,0,0,0,0,0,0,0.0,
30,Azhar Andani (PORT),2021-2021,4,4,0,0,0,0,0,0,0.0,
31,Azmat Ali (GER),2021-2021,2,2,0,0,0,0,0,0,0.0,
32,S Badrinath (INDIA),2011-2011,1,1,0,0,0,0,0,0,0.0,
33,C Bah (SLE),2021-2021,2,2,0,0,0,0,0,0,0.0,
34,LS Baker (WI),2008-2009,3,3,0,0,0,0,0,0,0.0,
35,L Balaji (INDIA),2012-2012,5,5,0,0,0,0,0,0,0.0,
36,AR Balla (CAM),2021-2021,2,2,0,0,0,0,0,0,0.0,
37,KMC Bandara (SL),2016-2016,1,1,0,0,0,0,0,0,0.0,
38,HH Banner (Blz),2019-2019,3,3,0,0,0,0,0,0,0.0,
39,NN Banner (Blz),2021-2021,2,2,0,0,0,0,0,0,0.0,
40,MC Bascombe (WI),2011-2011,1,1,0,0,0,0,0,0,0.0,
41,Bashir Shah (DEN),2019-2021,9,9,0,0,0,0,0,0,0.0,
42,TC Bastiampillai (CAN),2010-2010,2,2,0,0,0,0,0,0,0.0,
43,MD Bates (NZ),2012-2012,3,3,0,0,0,0,0,0,0.0,
44,GJ Batty (ENG),2009-2009,1,1,0,0,0,0,0,0,0.0,
45,D Bau (PNG),2017-2017,1,1,0,0,0,0,0,0,0.0,
46,CS Baugh (WI),2008-2012,3,3,0,0,0,0,0,0,0.0,
47,HK Bennett (NZ),2020-2021,10,10,0,0,0,0,0,0,0.0,
48,DE Bernard (WI),2009-2009,1,1,0,0,0,0,0,0,0.0,
49,TL Best (WI),2013-2014,6,6,0,0,0,0,0,0,0.0,
0,P Bharat Patel (PNM),2019-2019,2,2,0,0,0,0,0,0,0.0,
1,R Bhardwaj (PORT),2021-2021,1,1,0,0,0,0,0,0,0.0,
2,S Bhari (NEPAL),2019-2021,9,9,0,0,0,0,0,0,0.0,
3,A Bhattarai (NEPAL),2014-2014,1,1,0,0,0,0,0,0,0.0,
4,U Bhatti (CAN),2008-2010,7,7,0,0,0,0,0,0,0.0,
5,LT Bichard (GUE),2020-2020,1,1,0,0,0,0,0,0,0.0,
6,Bilal Aftab (DEN),2021-2021,3,3,0,0,0,0,0,0,0.0,
7,Bilal Ahmed (SRB),2019-2019,1,1,0,0,0,0,0,0,0.0,
8,IS Billcliff (CAN),2010-2010,2,2,0,0,0,0,0,0,0.0,
9,STR Binny (INDIA),2015-2016,3,3,0,0,0,0,0,0,0.0,
10,KK Bishnoi (),2019-2019,3,3,0,0,0,0,0,0,0.0,
11,CC Blake (VAN),2019-2019,3,3,0,0,0,0,0,0,0.0,
12,AM Blignaut (ZIM),2010-2010,1,1,0,0,0,0,0,0,0.0,
13,GH Bodi (SA),2007-2007,1,1,0,0,0,0,0,0,0.0,
14,N Boje (SA),2005-2005,1,1,0,0,0,0,0,0,0.0,
15,NE Bonner (WI),2011-2012,2,2,0,0,0,0,0,0,0.0,
16,CJ Boyce (AUS),2014-2016,7,7,0,0,0,0,0,0,0.0,
17,DL Brangman (BMUDA),2019-2019,4,4,0,0,0,0,0,0,0.0,
18,R Brar (CYP),2021-2021,1,1,0,0,0,0,0,0,0.0,
19,M Breban (GUE),2020-2020,1,1,0,0,0,0,0,0,0.0,
20,C Brennan (JER),2021-2021,2,2,0,0,0,0,0,0,0.0,
21,HC Brook (ENG),2022-2022,1,1,0,0,0,0,0,0,0.0,
22,CA Brown (Blz),2021-2021,4,4,0,0,0,0,0,0,0.0,
23,DR Brown (SCOT),2007-2007,1,1,0,0,0,0,0,0,0.0,
24,PL Bruno (Arg),2021-2021,6,6,0,0,0,0,0,0,0.0,
25,NB Budayair (NEPAL),2014-2014,4,4,0,0,0,0,0,0,0.0,
26,T Bukenya (UGA),2020-2021,4,4,0,0,0,0,0,0,0.0,
27,A Bulow (DEN),2019-2019,1,1,0,0,0,0,0,0,0.0,
28,Z Burgess (BMUDA),2021-2021,3,3,0,0,0,0,0,0,0.0,
29,CG Burnett (SCOT),2013-2013,1,1,0,0,0,0,0,0,0.0,
30,S Byrne (MLT),2019-2019,2,2,0,0,0,0,0,0,0.0,
31,P Byron (SEY),2021-2021,1,1,0,0,0,0,0,0,0.0,
32,G Caisley (),2019-2019,4,4,0,0,0,0,0,0,0.0,
33,L Canessane (Fran),2021-2021,2,2,0,0,0,0,0,0,0.0,
34,FE Carava (MOZ),2021-2021,2,2,0,0,0,0,0,0,0.0,
35,A Carthew (Chile),2019-2019,4,4,0,0,0,0,0,0,0.0,
36,T Caruana (GIBR),2019-2019,2,2,0,0,0,0,0,0,0.0,
37,D Cato (Caym),2019-2019,3,3,0,0,0,0,0,0,0.0,
38,JJ Celestine (BMUDA),2008-2008,3,3,0,0,0,0,0,0,0.0,
39,ARA Chambers (PORT),2021-2021,4,4,0,0,0,0,0,0,0.0,
40,TD Chaoana (LES),2021-2021,5,5,0,0,0,0,0,0,0.0,
41,Charanjeet Singh (ITA),2019-2019,2,2,0,0,0,0,0,0,0.0,
42,RL Chase (WI),2021-2021,3,3,0,0,0,0,0,0,0.0,
43,M Chauhan (Fin),2019-2019,2,2,0,0,0,0,0,0,0.0,
44,JF Chester (),2021-2021,4,4,0,0,0,0,0,0,0.0,
45,Chirag Suri (UAE),2018-2021,16,16,0,0,0,0,0,0,0.0,
46,M Choamba (MWI),2021-2021,2,2,0,0,0,0,0,0,0.0,
47,S Chophel (BHU),2019-2019,1,1,0,0,0,0,0,0,0.0,
48,DO Christian (WI),2011-2011,2,2,0,0,0,0,0,0,0.0,
49,I Civric (SRB),2019-2019,1,1,0,0,0,0,0,0,0.0,
0,GL Cloete (SA),2018-2019,2,2,0,0,0,0,0,0,0.0,
1,FRJ Coleman (SCOT),2013-2013,1,1,0,0,0,0,0,0,0.0,
2,MNR Cooray (Mald),2019-2020,6,6,0,0,0,0,0,0,0.0,
3,SJ Cotter (Samoa),2019-2019,4,4,0,0,0,0,0,0,0.0,
4,MS Crane (ENG),2017-2017,2,2,0,0,0,0,0,0,0.0,
5,T Cross (EST),2021-2021,2,2,0,0,0,0,0,0,0.0,
6,R Cunningham (GIBR),2021-2021,4,4,0,0,0,0,0,0,0.0,
7,SM Curran (ENG),2019-2021,16,16,0,0,0,0,0,0,0.0,
8,D Daesrath (CAN),2013-2013,1,1,0,0,0,0,0,0,0.0,
9,H Dajc (SRB),2019-2019,2,2,0,0,0,0,0,0,0.0,
10,IDA Damarell (GUE),2020-2020,1,1,0,0,0,0,0,0,0.0,
11,Danish Aziz (PAK),2021-2021,2,2,0,0,0,0,0,0,0.0,
12,I Danladi (NGA),2019-2019,3,3,0,0,0,0,0,0,0.0,
13,JT Darrell (BMUDA),2021-2021,1,1,0,0,0,0,0,0,0.0,
14,H Davids (SA),2012-2013,9,9,0,0,0,0,0,0,0.0,
15,R Davson (Bhm),2021-2021,3,3,0,0,0,0,0,0,0.0,
16,Dawlat Ahmadzai (AFG),2010-2010,2,2,0,0,0,0,0,0,0.0,
17,DC Delany (IRE),2019-2019,8,8,0,0,0,0,0,0,0.0,
18,D de la Puente (Peru),2019-2019,2,2,0,0,0,0,0,0,0.0,
19,PA Desai (CAN),2012-2012,1,1,0,0,0,0,0,0,0.0,
20,ST de Silva (SL),2017-2017,3,3,0,0,0,0,0,0,0.0,
21,BJ Diamanti (NZ),2009-2009,1,1,0,0,0,0,0,0,0.0,
22,V Dikov (BUL),2019-2019,3,3,0,0,0,0,0,0,0.0,
23,LHD Dilhara (SL),2008-2008,2,2,0,0,0,0,0,0,0.0,
24,SDJJ Dima (MOZ),2019-2021,7,7,0,0,0,0,0,0,0.0,
25,N Dipakkumar Patel (PNM),2019-2019,3,3,0,0,0,0,0,0,0.0,
26,HH Dippenaar (SA),2006-2006,1,1,0,0,0,0,0,0,0.0,
27,A Djorovic (SRB),2019-2021,6,6,0,0,0,0,0,0,0.0,
28,XJ Doherty (AUS),2012-2013,11,11,0,0,0,0,0,0,0.0,
29,MR Dorgan (SRB),2021-2021,3,3,0,0,0,0,0,0,0.0,
30,JN Dorji (BHU),2019-2019,1,1,0,0,0,0,0,0,0.0,
31,K Dorji (BHU),2019-2019,2,2,0,0,0,0,0,0,0.0,
32,RM Dorji (BHU),2019-2019,1,1,0,0,0,0,0,0,0.0,
33,U Dorji (BHU),2019-2019,2,2,0,0,0,0,0,0,0.0,
34,TM Dowlin (WI),2009-2010,2,2,0,0,0,0,0,0,0.0,
35,DC Drakes (WI),2021-2022,4,4,0,0,0,0,0,0,0.0,
36,R Dravid (INDIA),2011-2011,1,1,0,0,0,0,0,0,0.0,
37,BM Duckett (ENG),2019-2019,1,1,0,0,0,0,0,0,0.0,
38,JA Duffy (NZ),2020-2021,4,4,0,0,0,0,0,0,0.0,
39,B Dugic (SRB),2019-2019,2,2,0,0,0,0,0,0,0.0,
40,J Dunn (VAN),2019-2019,4,4,0,0,0,0,0,0,0.0,
41,MD du Preez (NAM),2021-2021,3,3,0,0,0,0,0,0,0.0,
42,A Dutt (NED),2021-2021,4,4,0,0,0,0,0,0,0.0,
43,PS Eaglestone (IRE),2010-2010,1,1,0,0,0,0,0,0,0.0,
44,KR Ebanks (Caym),2019-2019,5,5,0,0,0,0,0,0,0.0,
45,Ehsan Nawaz (HKG),2014-2017,5,5,0,0,0,0,0,0,0.0,
46,AM Ellis (NZ),2012-2013,4,4,0,0,0,0,0,0,0.0,
47,NT Ellis (AUS),2021-2021,2,2,0,0,0,0,0,0,0.0,
48,C Emmott (Chile),2019-2019,2,2,0,0,0,0,0,0,0.0,
49,RR Emrit (WI),2018-2018,4,4,0,0,0,0,0,0,0.0,
0,Faizan Asif (UAE),2014-2015,6,6,0,0,0,0,0,0,0.0,
1,Faizan Mumtaz (NOR),2021-2021,3,3,0,0,0,0,0,0,0.0,
2,Fakhrul Mohon (PORT),2019-2019,4,4,0,0,0,0,0,0,0.0,
3,M Faraz Akram (ZIM),2020-2021,2,2,0,0,0,0,0,0,0.0,
4,Fawad Ahmed (AUS),2013-2013,2,2,0,0,0,0,0,0,0.0,
5,Fayaz Khan (GER),2021-2021,1,1,0,0,0,0,0,0,0.0,
6,Fazalhaq Farooqi (AFG),2021-2021,1,1,0,0,0,0,0,0,0.0,
7,Fazal Niazai (AFG),2019-2019,1,1,0,0,0,0,0,0,0.0,
8,BOP Fernando (SL),2019-2021,6,6,0,0,0,0,0,0,0.0,
9,MGSM Fernando (ITA),2021-2021,6,6,0,0,0,0,0,0,0.0,
10,MVT Fernando (SL),2017-2017,1,1,0,0,0,0,0,0,0.0,
11,Fiaz Ahmad (KUW),2019-2019,3,3,0,0,0,0,0,0,0.0,
12,Fida Hussain (ITA),2019-2019,2,2,0,0,0,0,0,0,0.0,
13,T Filer (EST),2021-2021,5,5,0,0,0,0,0,0,0.0,
14,R Flannigan (SCOT),2012-2012,4,4,0,0,0,0,0,0,0.0,
15,KK Flowers (Blz),2019-2019,3,3,0,0,0,0,0,0,0.0,
16,C Floyd (NED),2019-2019,2,2,0,0,0,0,0,0,0.0,
17,M Fontaine (HUN),2021-2021,1,1,0,0,0,0,0,0,0.0,
18,C Forbes (),2021-2021,6,6,0,0,0,0,0,0,0.0,
19,AR Gandhi (KENYA),2019-2019,3,3,0,0,0,0,0,0,0.0,
20,D Ganga (WI),2006-2006,1,1,0,0,0,0,0,0,0.0,
21,GHS Garton (ENG),2022-2022,1,1,0,0,0,0,0,0,0.0,
22,SP Gauchan (NEPAL),2014-2015,9,9,0,0,0,0,0,0,0.0,
23,A Gavde (Caym),2019-2019,1,1,0,0,0,0,0,0,0.0,
24,A Gbla (SLE),2021-2021,8,8,0,0,0,0,0,0,0.0,
25,B Geeves (AUS),2009-2009,1,1,0,0,0,0,0,0,0.0,
26,J Ghadiyali (),2021-2021,6,6,0,0,0,0,0,0,0.0,
27,L Gherasim (ROM),2019-2020,3,3,0,0,0,0,0,0,0.0,
28,M Gherasim (ROM),2020-2020,2,2,0,0,0,0,0,0,0.0,
29,JN Gillespie (AUS),2005-2005,1,1,0,0,0,0,0,0,0.0,
30,O Goker (TKY),2019-2019,1,1,0,0,0,0,0,0,0.0,
31,GF Gomes (MOZ),2019-2019,6,6,0,0,0,0,0,0,0.0,
32,D Gough (ENG),2005-2006,2,2,0,0,0,0,0,0,0.0,
33,S Goustis (GRC),2019-2019,3,3,0,0,0,0,0,0,0.0,
34,K Govind (SEY),2021-2021,1,1,0,0,0,0,0,0,0.0,
35,L Gregory (ENG),2019-2021,8,8,0,0,0,0,0,0,0.0,
36,R Gunasekera (CAN),2012-2013,8,8,0,0,0,0,0,0,0.0,
37,HF Gurney (ENG),2014-2014,2,2,0,0,0,0,0,0,0.0,
38,A Halbhavi (LUX),2021-2021,3,3,0,0,0,0,0,0,0.0,
39,AJ Hall (SA),2006-2006,2,2,0,0,0,0,0,0,0.0,
40,Hamid Hashemi (Iran),2020-2020,1,1,0,0,0,0,0,0,0.0,
41,PSP Handscomb (AUS),2019-2019,2,2,0,0,0,0,0,0,0.0,
42,Hardev Singh (Chile),2019-2019,3,3,0,0,0,0,0,0,0.0,
43,A Harikumar (BUL),2021-2021,1,1,0,0,0,0,0,0,0.0,
44,HL Harji (SEY),2021-2021,2,2,0,0,0,0,0,0,0.0,
45,Haroon Arshad (HKG),2019-2020,17,17,0,0,0,0,0,0,0.0,
46,LHB Harrington-Myers (Caym),2019-2019,4,4,0,0,0,0,0,0,0.0,
47,A Harris (Bhm),2021-2021,1,1,0,0,0,0,0,0,0.0,
48,RJ Harris (AUS),2010-2010,3,3,0,0,0,0,0,0,0.0,
49,SM Harwood (AUS),2007-2009,3,3,0,0,0,0,0,0,0.0,
0,Hasan Mahmud (BAN),2020-2020,1,1,0,0,0,0,0,0,0.0,
1,Hasheem Shahzad (MLT),2019-2019,2,2,0,0,0,0,0,0,0.0,
2,Hashir Hussain (NOR),2021-2021,1,1,0,0,0,0,0,0,0.0,
3,Hassan Khan Mohammad (HKG),2020-2020,1,1,0,0,0,0,0,0,0.0,
4,Hassan Rasheed (Mald),2019-2021,11,11,0,0,0,0,0,0,0.0,
5,RJ Hatchman (GIBR),2019-2021,5,5,0,0,0,0,0,0,0.0,
6,NM Hauritz (AUS),2009-2009,2,2,0,0,0,0,0,0,0.0,
7,Hayatullah Niazi (NOR),2019-2019,4,4,0,0,0,0,0,0,0.0,
8,H Helva (TKY),2019-2019,4,4,0,0,0,0,0,0,0.0,
9,DL Hemp (BMUDA),2008-2008,2,2,0,0,0,0,0,0,0.0,
10,T Henderson (SA),2006-2006,1,1,0,0,0,0,0,0,0.0,
11,HMRKB Herath (SL),2011-2016,17,17,0,0,0,0,0,0,0.0,
12,BW Hilfenhaus (AUS),2007-2012,7,7,0,0,0,0,0,0,0.0,
13,J Hill (PHI),2019-2019,3,3,0,0,0,0,0,0,0.0,
14,J Hirschi (MLT),2019-2019,4,4,0,0,0,0,0,0,0.0,
15,Hisham Sheikh (Saudi),2021-2021,4,4,0,0,0,0,0,0,0.0,
16,PA Hitchcock (NZ),2008-2008,1,1,0,0,0,0,0,0,0.0,
17,S Hongsi (THAI),2019-2019,3,3,0,0,0,0,0,0,0.0,
18,PJ Hughes (AUS),2014-2014,1,1,0,0,0,0,0,0,0.0,
19,Humayun Kabir (SWE),2021-2021,3,3,0,0,0,0,0,0,0.0,
20,EH Hutchinson (USA),2019-2021,3,3,0,0,0,0,0,0,0.0,
21,Ibrahim Khan (Saudi),2019-2019,1,1,0,0,0,0,0,0,0.0,
22,Iftikhar Anjum (PAK),2007-2009,2,2,0,0,0,0,0,0,0.0,
23,Ijaz Hussain (ROM),2019-2021,10,10,0,0,0,0,0,0,0.0,
24,Imal Zuwak (SWE),2021-2021,4,4,0,0,0,0,0,0,0.0,
25,Imam-ul-Haq (PAK),2019-2019,2,2,0,0,0,0,0,0,0.0,
26,Imran Bulbulia (PNM),2019-2019,3,3,0,0,0,0,0,0,0.0,
27,RK Inampud (Mex),2019-2019,3,3,0,0,0,0,0,0,0.0,
28,Inzamam-ul-Haq (PAK),2006-2006,1,1,0,0,0,0,0,0,0.0,
29,K Irakoze (RWN),2021-2021,11,11,0,0,0,0,0,0,0.0,
30,AJ Ireland (ZIM),2006-2006,1,1,0,0,0,0,0,0,0.0,
31,Irfan Bhima (MWI),2019-2019,4,4,0,0,0,0,0,0,0.0,
32,Irfan Hafejee (PNM),2021-2021,6,6,0,0,0,0,0,0,0.0,
33,Irfan Mir (Chile),2019-2019,4,4,0,0,0,0,0,0,0.0,
34,G Irvin (Bhm),2021-2021,2,2,0,0,0,0,0,0,0.0,
35,E Isaneez (UGA),2019-2019,3,3,0,0,0,0,0,0,0.0,
36,Ismail Sardar (THAI),2020-2020,2,2,0,0,0,0,0,0,0.0,
37,VR Iyer (INDIA),2021-2021,3,3,0,0,0,0,0,0,0.0,
38,J Jagroo (Bhm),2021-2021,6,6,0,0,0,0,0,0,0.0,
39,D Jakiel (ZIM),2019-2019,2,2,0,0,0,0,0,0,0.0,
40,NA Janes (THAI),2019-2019,2,2,0,0,0,0,0,0,0.0,
41,T Jamtsho (BHU),2019-2019,2,2,0,0,0,0,0,0,0.0,
42,D Jansen (IOM),2021-2021,1,1,0,0,0,0,0,0,0.0,
43,AA Jasani (TAN),2021-2021,6,6,0,0,0,0,0,0,0.0,
44,Javed Ahmadi (AFG),2012-2017,3,3,0,0,0,0,0,0,0.0,
45,Javed Maroofkhail (NOR),2019-2019,2,2,0,0,0,0,0,0,0.0,
46,CU Jayasinghe (SL),2009-2010,5,5,0,0,0,0,0,0,0.0,
47,P Jayawickrama (SL),2021-2021,1,1,0,0,0,0,0,0,0.0,
48,P Jayeshbhai Patel (PNM),2019-2019,2,2,0,0,0,0,0,0,0.0,
49,Jay Odedra (OMA),2019-2019,3,3,0,0,0,0,0,0,0.0,
0,JS Jesani (KENYA),2007-2007,1,1,0,0,0,0,0,0,0.0,
1,Jitin Singh (TAN),2021-2021,10,10,0,0,0,0,0,0,0.0,
2,NR Johns-Wickberg (SRB),2021-2021,4,4,0,0,0,0,0,0,0.0,
3,Jojo Thomas (MLT),2021-2021,1,1,0,0,0,0,0,0,0.0,
4,GJ Joseph (Blz),2019-2019,1,1,0,0,0,0,0,0,0.0,
5,K Joshi (Aut),2019-2021,8,8,0,0,0,0,0,0,0.0,
6,RR Joshi (CAN),2021-2021,1,1,0,0,0,0,0,0,0.0,
7,Jubair Hossain (BAN),2015-2015,1,1,0,0,0,0,0,0,0.0,
8,SA Jumbe (TAN),2021-2021,7,7,0,0,0,0,0,0,0.0,
9,Junaid Khan (PAK),2011-2014,9,9,0,0,0,0,0,0,0.0,
10,Junaid Khan (PORT),2021-2021,4,4,0,0,0,0,0,0,0.0,
11,S Jyoti (CAN),2008-2008,2,2,0,0,0,0,0,0,0.0,
12,M Kadyan (BUL),2021-2021,2,2,0,0,0,0,0,0,0.0,
13,B Kalki Kumar (MLT),2021-2021,2,2,0,0,0,0,0,0,0.0,
14,G Kaltongga (VAN),2019-2019,3,3,0,0,0,0,0,0,0.0,
15,S Randiv (SL),2010-2011,7,7,0,0,0,0,0,0,0.0,
16,D Kalvin (SEY),2021-2021,6,6,0,0,0,0,0,0,0.0,
17,TP Kamungozi (ZIM),2014-2014,1,1,0,0,0,0,0,0,0.0,
18,S Kansoy (TKY),2019-2019,4,4,0,0,0,0,0,0,0.0,
19,B Karki (NEPAL),2020-2020,1,1,0,0,0,0,0,0,0.0,
20,A Karn (NEPAL),2015-2015,2,2,0,0,0,0,0,0,0.0,
21,M Kartik (INDIA),2007-2007,1,1,0,0,0,0,0,0,0.0,
22,E Katchay (CAN),2008-2008,4,4,0,0,0,0,0,0,0.0,
23,S Kaul (INDIA),2018-2019,3,3,0,0,0,0,0,0,0.0,
24,HB Kayondo (UGA),2019-2021,4,4,0,0,0,0,0,0,0.0,
25,D Kegasitswe (BOT),2019-2019,4,4,0,0,0,0,0,0,0.0,
26,SKW Kelly (BMUDA),2008-2008,3,3,0,0,0,0,0,0,0.0,
27,P Kerai (KENYA),2019-2019,6,6,0,0,0,0,0,0,0.0,
28,Khalid Ahmadi (Belg),2020-2021,9,9,0,0,0,0,0,0,0.0,
29,A Khan (DEN/ENG),2009-2021,6,6,0,0,0,0,0,0,0.0,
30,Khawar Zafar (Saudi),2020-2020,2,2,0,0,0,0,0,0,0.0,
31,A Kheterpal (HUN),2021-2021,4,4,0,0,0,0,0,0,0.0,
32,B Khumalo (BOT),2019-2021,4,4,0,0,0,0,0,0,0.0,
33,Khurram Manzoor (PAK),2016-2016,3,3,0,0,0,0,0,0,0.0,
34,JH Kiani (PHI),2019-2019,3,3,0,0,0,0,0,0,0.0,
35,GE Kidd (IRE),2010-2010,1,1,0,0,0,0,0,0,0.0,
36,VJ Kingma (NED),2016-2021,9,9,0,0,0,0,0,0,0.0,
37,RJ Kirtley (ENG),2007-2007,1,1,0,0,0,0,0,0,0.0,
38,S Kizilkaya (TKY),2019-2019,4,4,0,0,0,0,0,0,0.0,
39,N Knights (IOM),2020-2021,5,5,0,0,0,0,0,0,0.0,
40,MF Koc (TKY),2019-2019,3,3,0,0,0,0,0,0,0.0,
41,PK Langat (KENYA),2021-2021,6,6,0,0,0,0,0,0,0.0,
42,AC Kose (TKY),2019-2019,4,4,0,0,0,0,0,0,0.0,
43,A Krishna (SGP),2019-2020,7,7,0,0,0,0,0,0,0.0,
44,GJP Kruger (SA),2006-2006,1,1,0,0,0,0,0,0,0.0,
45,S Kubheka (),2021-2021,5,5,0,0,0,0,0,0,0.0,
46,Kuldeep Singh (PHI),2019-2019,3,3,0,0,0,0,0,0,0.0,
47,DS Kulkarni (INDIA),2016-2016,2,2,0,0,0,0,0,0,0.0,
48,C Kyewuta (UGA),2021-2021,2,2,0,0,0,0,0,0,0.0,
49,GA Lamb (ZIM),2010-2010,5,5,0,0,0,0,0,0,0.0,
0,T Langa (VAN),2019-2019,1,1,0,0,0,0,0,0,0.0,
1,CJ Langford (IOM),2020-2021,4,4,0,0,0,0,0,0,0.0,
2,E Leie (SA),2015-2015,2,2,0,0,0,0,0,0,0.0,
3,M Leporoporo (LES),2021-2021,4,4,0,0,0,0,0,0,0.0,
4,T Letsitsa (LES),2021-2021,1,1,0,0,0,0,0,0,0.0,
5,RDM Leverock (BMUDA),2008-2008,2,2,0,0,0,0,0,0,0.0,
6,C Liebenberg (IOM),2020-2020,1,1,0,0,0,0,0,0,0.0,
7,I Lisboa (Chile),2019-2019,1,1,0,0,0,0,0,0,0.0,
8,CA Liyanage (Mald),2019-2020,3,3,0,0,0,0,0,0,0.0,
9,NG Liyanage (HUN),2021-2021,2,2,0,0,0,0,0,0,0.0,
10,K Loday (BHU),2019-2019,1,1,0,0,0,0,0,0,0.0,
11,DB Loic (CAM),2021-2021,4,4,0,0,0,0,0,0,0.0,
12,J Louw (SA),2008-2009,2,2,0,0,0,0,0,0,0.0,
13,L Louwrens (NAM),2019-2019,1,1,0,0,0,0,0,0,0.0,
14,WJ Lubbe (SA),2021-2021,2,2,0,0,0,0,0,0,0.0,
15,NM Lyon (AUS),2016-2018,2,2,0,0,0,0,0,0,0.0,
16,RT Lyons (SCOT),2010-2010,2,2,0,0,0,0,0,0,0.0,
17,AM McCarthy (WI),2018-2018,1,1,0,0,0,0,0,0,0.0,
18,NFI McCallum (SCOT),2007-2010,10,10,0,0,0,0,0,0,0.0,
19,AJ McKay (NZ),2010-2010,2,2,0,0,0,0,0,0,0.0,
20,CJ McKay (AUS),2010-2013,6,6,0,0,0,0,0,0,0.0,
21,ND McKenzie (SA),2006-2009,2,2,0,0,0,0,0,0,0.0,
22,SKDT Madusanka (SEY),2021-2021,6,6,0,0,0,0,0,0,0.0,
23,DSK Madushanka (SL),2018-2018,2,2,0,0,0,0,0,0,0.0,
24,LD Madushanka (SL),2019-2021,3,3,0,0,0,0,0,0,0.0,
25,RP Magar (NEPAL),2014-2015,6,6,0,0,0,0,0,0,0.0,
26,R Mahajan (PHI),2019-2019,2,2,0,0,0,0,0,0,0.0,
27,C Mahoney (Peru),2019-2019,3,3,0,0,0,0,0,0,0.0,
28,Maidul Islam (EST),2021-2021,6,6,0,0,0,0,0,0,0.0,
29,A Manatos (GRC),2021-2021,1,1,0,0,0,0,0,0,0.0,
30,Maqsood Ahmad (Belg),2021-2021,3,3,0,0,0,0,0,0,0.0,
31,M Markande (INDIA),2019-2019,1,1,0,0,0,0,0,0,0.0,
32,D Marks (MLT),2019-2019,2,2,0,0,0,0,0,0,0.0,
33,JAH Marshall (NZ),2005-2008,3,3,0,0,0,0,0,0,0.0,
34,JL Martel (GUE),2019-2019,2,2,0,0,0,0,0,0,0.0,
35,JC Martin (GUE),2020-2020,1,1,0,0,0,0,0,0,0.0,
36,T Marumani (ZIM),2021-2021,11,11,0,0,0,0,0,0,0.0,
37,P Masih (ROM),2020-2020,3,3,0,0,0,0,0,0,0.0,
38,MJ Mason (NZ),2006-2008,3,3,0,0,0,0,0,0,0.0,
39,Masood Jayezeh (Iran),2020-2020,3,3,0,0,0,0,0,0,0.0,
40,N Master (BOT),2019-2019,2,2,0,0,0,0,0,0,0.0,
41,J Matharu (CAN),2021-2021,5,5,0,0,0,0,0,0,0.0,
42,MV Matsau (LES),2021-2021,5,5,0,0,0,0,0,0,0.0,
43,GJ McCarter (IRE),2015-2015,2,2,0,0,0,0,0,0,0.0,
44,BJ McCarthy (IRE),2017-2021,16,16,0,0,0,0,0,0,0.0,
45,W McClintock (IRE),2021-2021,5,5,0,0,0,0,0,0,0.0,
46,Z McLaughlin (Caym),2019-2019,3,3,0,0,0,0,0,0,0.0,
47,A Mehmood (HKG),2016-2016,2,2,0,0,0,0,0,0,0.0,
48,Junaid Mehmood (NOR),2021-2021,2,2,0,0,0,0,0,0,0.0,
49,Mehrab Hossain jnr (BAN),2008-2009,2,2,0,0,0,0,0,0,0.0,
0,Mehran Dorri (Iran),2020-2020,1,1,0,0,0,0,0,0,0.0,
1,Mehran Siasar (Iran),2020-2020,1,1,0,0,0,0,0,0,0.0,
2,KP Meiyappan (UAE),2021-2021,2,2,0,0,0,0,0,0,0.0,
3,D Mejia (CRC),2019-2019,3,3,0,0,0,0,0,0,0.0,
4,RTM Mendis (SL),2021-2021,2,2,0,0,0,0,0,0,0.0,
5,AB Mengoumou (CAM),2021-2021,1,1,0,0,0,0,0,0,0.0,
6,JH Mensah (Ghana),2019-2019,2,2,0,0,0,0,0,0,0.0,
7,RP Meredith (AUS),2021-2021,5,5,0,0,0,0,0,0,0.0,
8,DP Michael (Samoa),2019-2019,4,4,0,0,0,0,0,0,0.0,
9,Michael Nazir (MLT),2019-2019,1,1,0,0,0,0,0,0,0.0,
10,Mihusan Hamid (Mald),2019-2019,1,1,0,0,0,0,0,0,0.0,
11,S Mills (IOM),2020-2020,1,1,0,0,0,0,0,0,0.0,
12,Mirza Ahsan (Aut),2019-2021,8,8,0,0,0,0,0,0,0.0,
13,A Mishra (INDIA),2010-2017,9,9,0,0,0,0,0,0,0.0,
14,Y Mitari (RWN),2021-2021,5,5,0,0,0,0,0,0,0.0,
15,Mobashar Ashraf (Fran),2021-2021,2,2,0,0,0,0,0,0,0.0,
16,D Mogan (MAL),2020-2021,3,3,0,0,0,0,0,0,0.0,
17,Mohammad Adnan (Saudi),2019-2019,5,5,0,0,0,0,0,0,0.0,
18,Mohammad Ahsan (KUW),2019-2019,6,6,0,0,0,0,0,0,0.0,
19,Mohammad Ayaz (UAE),2020-2020,1,1,0,0,0,0,0,0,0.0,
20,Mohammad Hasnain (PAK),2019-2021,18,18,0,0,0,0,0,0,0.0,
21,Mohammad Iqbal (CAN),2008-2008,3,3,0,0,0,0,0,0,0.0,
22,Mohamed Mahfooz (Mald),2019-2021,14,14,0,0,0,0,0,0,0.0,
23,Mohammad Qazi (CAN),2008-2008,1,1,0,0,0,0,0,0,0.0,
24,Mohammad Rafique (BAN),2006-2006,1,1,0,0,0,0,0,0,0.0,
25,Mohammad Shahid (BAN),2016-2016,1,1,0,0,0,0,0,0,0.0,
26,Mohammed Sameer (BHR),2020-2020,2,2,0,0,0,0,0,0,0.0,
27,L Monanthane (LES),2021-2021,2,2,0,0,0,0,0,0,0.0,
28,MR Montfort (CAN),2019-2019,1,1,0,0,0,0,0,0,0.0,
29,VV Morea (PNG),2015-2017,5,5,0,0,0,0,0,0,0.0,
30,A Morris (Caym),2019-2019,6,6,0,0,0,0,0,0,0.0,
31,Mohsin Hub (Peru),2019-2019,4,4,0,0,0,0,0,0,0.0,
32,Mohsin Khan (HKG),2020-2020,3,3,0,0,0,0,0,0,0.0,
33,G Moti-Kanhai (WI),2021-2021,1,1,0,0,0,0,0,0,0.0,
34,N Mourikis (GRC),2021-2021,2,2,0,0,0,0,0,0,0.0,
35,Muaviath Ganee (Mald),2019-2019,5,5,0,0,0,0,0,0,0.0,
36,Muhammad Ansar (KUW),2020-2020,4,4,0,0,0,0,0,0,0.0,
37,Muhammad Hamayun (Saudi),2019-2019,4,4,0,0,0,0,0,0,0.0,
38,Muhammad Musa (PAK),2019-2020,2,2,0,0,0,0,0,0,0.0,
39,Muhammad Rafique (BHR),2019-2019,2,2,0,0,0,0,0,0,0.0,
40,Muhammed Shanil (UAE),2016-2016,1,1,0,0,0,0,0,0,0.0,
41,Muhammad Zaghlool (Blz),2021-2021,2,2,0,0,0,0,0,0,0.0,
42,Mukhtiar Singh (ESP),2019-2019,2,2,0,0,0,0,0,0,0.0,
43,Muktar Ali (BAN),2016-2016,1,1,0,0,0,0,0,0,0.0,
44,FF Mulivai (Samoa),2019-2019,4,4,0,0,0,0,0,0,0.0,
45,CT Mumba (ZIM),2020-2020,2,2,0,0,0,0,0,0,0.0,
46,T Mupariwa (ZIM),2007-2008,4,4,0,0,0,0,0,0,0.0,
47,S Murari (CRC),2019-2019,3,3,0,0,0,0,0,0,0.0,
48,Mustapha Yusuf (NGA),2021-2021,5,5,0,0,0,0,0,0,0.0,
49,P Mustard (ENG),2008-2008,2,2,0,0,0,0,0,0,0.0,
0,F Mutizwa (ZIM),2011-2012,3,3,0,0,0,0,0,0,0.0,
1,M Mwamadi (MWI),2019-2021,8,8,0,0,0,0,0,0,0.0,
2,Nader Zahadiafzal (Iran),2020-2020,3,3,0,0,0,0,0,0,0.0,
3,Nadif Chowdhury (BAN),2006-2007,3,3,0,0,0,0,0,0,0.0,
4,Naiem Bameri (Iran),2020-2020,3,3,0,0,0,0,0,0,0.0,
5,Najeeb Amar (HKG),2014-2014,1,1,0,0,0,0,0,0,0.0,
6,M Nandela (Mex),2019-2019,2,2,0,0,0,0,0,0,0.0,
7,A Nao (PNG),2017-2017,2,2,0,0,0,0,0,0,0.0,
8,Nasir Aziz (UAE),2015-2015,1,1,0,0,0,0,0,0,0.0,
9,Nasrulla Rana (HKG),2019-2020,11,11,0,0,0,0,0,0,0.0,
10,T Natarajan (INDIA),2020-2021,4,4,0,0,0,0,0,0,0.0,
11,Nauman Anwar (PAK),2015-2015,1,1,0,0,0,0,0,0,0.0,
12,NH Naureen (ESP),2019-2019,1,1,0,0,0,0,0,0,0.0,
13,AA Navicha (MOZ),2021-2021,2,2,0,0,0,0,0,0,0.0,
14,Navid Balouch (Iran),2020-2020,3,3,0,0,0,0,0,0,0.0,
15,Navid Abdollahpour (Iran),2020-2020,2,2,0,0,0,0,0,0,0.0,
16,Nazimuddin (BAN),2007-2008,7,7,0,0,0,0,0,0,0.0,
17,Nazmul Hossain (BAN),2009-2012,4,4,0,0,0,0,0,0,0.0,
18,Nazmus Sadat (BAN),2006-2006,1,1,0,0,0,0,0,0,0.0,
19,N Ndouteng (CAM),2021-2021,1,1,0,0,0,0,0,0,0.0,
20,R Neale (LUX),2019-2019,3,3,0,0,0,0,0,0,0.0,
21,S Nerandzic (SRB),2019-2019,2,2,0,0,0,0,0,0,0.0,
22,JO Ngoche (KENYA),2012-2013,7,7,0,0,0,0,0,0,0.0,
23,K Nima (BHU),2019-2019,1,1,0,0,0,0,0,0,0.0,
24,EM Nino (Arg),2021-2021,2,2,0,0,0,0,0,0,0.0,
25,W Niyitanga (RWN),2021-2021,4,4,0,0,0,0,0,0,0.0,
26,ML Nkala (ZIM),2006-2006,1,1,0,0,0,0,0,0,0.0,
27,F Nkhoma (MWI),2019-2019,3,3,0,0,0,0,0,0,0.0,
28,AA Noffke (AUS),2007-2008,2,2,0,0,0,0,0,0,0.0,
29,Noman Amjad (Fran),2021-2021,4,4,0,0,0,0,0,0,0.0,
30,Noman Kamawi (Belg),2019-2019,1,1,0,0,0,0,0,0,0.0,
31,MJ North (AUS),2009-2009,1,1,0,0,0,0,0,0,0.0,
32,L Nou (PNG),2015-2015,3,3,0,0,0,0,0,0,0.0,
33,GM Ntambalika (MWI),2019-2021,8,8,0,0,0,0,0,0,0.0,
34,J Nyumbu (ZIM),2018-2018,2,2,0,0,0,0,0,0,0.0,
35,IE O'Brien (NZ),2009-2009,4,4,0,0,0,0,0,0,0.0,
36,S Ogundipe (NGA),2021-2021,4,4,0,0,0,0,0,0,0.0,
37,NV Ojha (INDIA),2010-2010,2,2,0,0,0,0,0,0,0.0,
38,CB Ondoa (CAM),2021-2021,4,4,0,0,0,0,0,0,0.0,
39,PJ Ongondo (KENYA),2007-2008,8,8,0,0,0,0,0,0,0.0,
40,LN Onyango (KENYA),2007-2010,5,5,0,0,0,0,0,0,0.0,
41,A Orfila (GIBR),2019-2021,5,5,0,0,0,0,0,0,0.0,
42,Ovais Yousof (NGA),2019-2019,3,3,0,0,0,0,0,0,0.0,
43,VS Padhaal (Fin),2019-2021,9,9,0,0,0,0,0,0,0.0,
44,D Padikkal (INDIA),2021-2021,2,2,0,0,0,0,0,0,0.0,
45,RJG Palmer (JER),2019-2021,4,4,0,0,0,0,0,0,0.0,
46,MS Panesar (ENG),2007-2007,1,1,0,0,0,0,0,0,0.0,
47,BA Parchment (WI),2007-2007,1,1,0,0,0,0,0,0,0.0,
48,MA Parker (SCOT),2012-2012,2,2,0,0,0,0,0,0,0.0,
49,MW Parkinson (ENG),2019-2021,4,4,0,0,0,0,0,0,0.0,
0,Parvez Rasool (INDIA),2017-2017,1,1,0,0,0,0,0,0,0.0,
1,A Patel (MWI),2019-2019,2,2,0,0,0,0,0,0,0.0,
2,AY Patel (NZ),2018-2021,7,7,0,0,0,0,0,0,0.0,
3,KJ Patel (SEY),2021-2021,6,6,0,0,0,0,0,0,0.0,
4,M Patel (PNM),2019-2019,2,2,0,0,0,0,0,0,0.0,
5,M Patel (Chile),2019-2019,3,3,0,0,0,0,0,0,0.0,
6,MIA Patel (MWI),2019-2019,3,3,0,0,0,0,0,0,0.0,
7,MM Patel (INDIA),2011-2011,3,3,0,0,0,0,0,0,0.0,
8,SJ Patel (CZK-R),2021-2021,3,3,0,0,0,0,0,0,0.0,
9,TK Patel (USA),2019-2019,6,6,0,0,0,0,0,0,0.0,
10,N Pathan (THAI),2019-2020,8,8,0,0,0,0,0,0,0.0,
11,R Pathan (CAN),2021-2021,6,6,0,0,0,0,0,0,0.0,
12,SS Pathirana (SL),2016-2017,5,5,0,0,0,0,0,0,0.0,
13,TAW Patterson (Blz),2021-2021,3,3,0,0,0,0,0,0,0.0,
14,WA Peatfield (GUE),2019-2020,8,8,0,0,0,0,0,0,0.0,
15,MDK Perera (SL),2011-2011,3,3,0,0,0,0,0,0,0.0,
16,PDRL Perera (SL),2006-2006,2,2,0,0,0,0,0,0,0.0,
17,V Permaul (WI),2018-2018,1,1,0,0,0,0,0,0,0.0,
18,AM Phangiso (SA),2012-2018,16,16,0,0,0,0,0,0,0.0,
19,T Phaswana (BOT),2019-2019,1,1,0,0,0,0,0,0,0.0,
20,JR Philippe (AUS),2021-2021,10,10,0,0,0,0,0,0,0.0,
21,S Pillai (CRC),2019-2019,3,3,0,0,0,0,0,0,0.0,
22,LA Pomersbach (AUS),2007-2007,1,1,0,0,0,0,0,0,0.0,
23,B Pondani (MWI),2021-2021,3,3,0,0,0,0,0,0,0.0,
24,VRCF Poubel (),2019-2019,3,3,0,0,0,0,0,0,0.0,
25,H Pragji (BOT),2019-2019,4,4,0,0,0,0,0,0,0.0,
26,KH Prajapati (OMA),2021-2021,3,3,0,0,0,0,0,0,0.0,
27,C Prasad (CRC),2019-2019,3,3,0,0,0,0,0,0,0.0,
28,KTGD Prasad (SL),2011-2011,1,1,0,0,0,0,0,0,0.0,
29,AG Prince (SA),2005-2005,1,1,0,0,0,0,0,0,0.0,
30,SMA Priyanjan (SL),2017-2017,3,3,0,0,0,0,0,0,0.0,
31,Qais Ahmad (AFG),2020-2020,1,1,0,0,0,0,0,0,0.0,
32,Qalandar Khan (QAT),2019-2019,4,4,0,0,0,0,0,0,0.0,
33,Qasim Anwar (CYP),2021-2021,4,4,0,0,0,0,0,0,0.0,
34,Qasim Zia (BHR),2019-2019,3,3,0,0,0,0,0,0,0.0,
35,Rafatullah Mohmand (PAK),2015-2015,3,3,0,0,0,0,0,0,0.0,
36,Rahman Ademi (SRB),2019-2019,2,2,0,0,0,0,0,0,0.0,
37,P Raho (PNG),2016-2016,2,2,0,0,0,0,0,0,0.0,
38,PA Raikes (GIBR),2021-2021,4,4,0,0,0,0,0,0,0.0,
39,EC Rainsford (ZIM),2010-2010,2,2,0,0,0,0,0,0,0.0,
40,CAK Rajitha (SL),2016-2019,10,10,0,0,0,0,0,0,0.0,
41,T Rajiv (SEY),2021-2021,6,6,0,0,0,0,0,0,0.0,
42,Rakibul Hasan (ITA),2019-2019,7,7,0,0,0,0,0,0,0.0,
43,RLB Rambukwella (SL),2013-2016,2,2,0,0,0,0,0,0,0.0,
44,Rameez Raja (2) (PAK),2011-2011,2,2,0,0,0,0,0,0,0.0,
45,N Rana (INDIA),2021-2021,2,2,0,0,0,0,0,0,0.0,
46,SHA Rance (NZ),2017-2019,7,7,0,0,0,0,0,0,0.0,
47,DA Rankin (IRE),2015-2016,2,2,0,0,0,0,0,0,0.0,
48,RJ Ranpura (OMA),2015-2015,2,2,0,0,0,0,0,0,0.0,
49,Rashid Khan (NEPAL),2019-2019,1,1,0,0,0,0,0,0,0.0,
0,KB Ahir (PNM),2019-2021,8,8,0,0,0,0,0,0,0.0,
1,NJ Reardon (AUS),2014-2014,2,2,0,0,0,0,0,0,0.0,
2,J Reb (SRB),2019-2021,6,6,0,0,0,0,0,0,0.0,
3,S Rengarajan (CZK-R),2020-2020,3,3,0,0,0,0,0,0,0.0,
4,JB Reva (PNG),2015-2019,8,8,0,0,0,0,0,0,0.0,
5,A Reyes (GIBR),2021-2021,3,3,0,0,0,0,0,0,0.0,
6,C Rice (MWI),2021-2021,1,1,0,0,0,0,0,0,0.0,
7,ACL Richards (WI),2007-2007,1,1,0,0,0,0,0,0,0.0,
8,DM Richards (WI),2009-2009,1,1,0,0,0,0,0,0,0.0,
9,R Rivas (Chile),2019-2019,3,3,0,0,0,0,0,0,0.0,
10,Rizwan Mahmood (DEN),2019-2021,5,5,0,0,0,0,0,0,0.0,
11,Rizwan Mangera (PNM),2021-2021,4,4,0,0,0,0,0,0,0.0,
12,WJR Robertson (JER),2019-2019,6,6,0,0,0,0,0,0,0.0,
13,Robert Raina (THAI),2020-2020,4,4,0,0,0,0,0,0,0.0,
14,D Robeson (GIBR),2021-2021,1,1,0,0,0,0,0,0,0.0,
15,Robiul Islam (BAN),2013-2013,1,1,0,0,0,0,0,0,0.0,
16,SR Rocket (SEY),2021-2021,6,6,0,0,0,0,0,0,0.0,
17,GA Rogers (SCOT),2008-2009,2,2,0,0,0,0,0,0,0.0,
18,BJ Rohrer (AUS),2013-2013,1,1,0,0,0,0,0,0,0.0,
19,Rokhan Barakzai (AFG),2015-2015,3,3,0,0,0,0,0,0,0.0,
20,Rony Talukdar (BAN),2015-2015,1,1,0,0,0,0,0,0,0.0,
21,JA Rudolph (SA),2006-2006,1,1,0,0,0,0,0,0,0.0,
22,SI Runsewe (NGA),2019-2021,10,10,0,0,0,0,0,0,0.0,
23,TK Saha (Fin),2019-2019,4,4,0,0,0,0,0,0,0.0,
24,Sajid Liaqat (GER),2019-2021,5,5,0,0,0,0,0,0,0.0,
25,C Sakariya (INDIA),2021-2021,2,2,0,0,0,0,0,0,0.0,
26,Sakib Hasan (SRB),2019-2019,2,2,0,0,0,0,0,0,0.0,
27,BA Sambo (MOZ),2019-2019,2,2,0,0,0,0,0,0,0.0,
28,TW Samuels (Blz),2021-2021,5,5,0,0,0,0,0,0,0.0,
29,O Sam Arthur (CRC),2019-2019,3,3,0,0,0,0,0,0,0.0,
30,Sandeep Goud (Bhm),2021-2021,4,4,0,0,0,0,0,0,0.0,
31,Sandeep Sharma (INDIA),2015-2015,2,2,0,0,0,0,0,0,0.0,
32,S Sandeep Warrier (INDIA),2021-2021,1,1,0,0,0,0,0,0,0.0,
33,Sanjay Kumar (HUN),2021-2021,2,2,0,0,0,0,0,0,0.0,
34,OT Sankoh (SLE),2021-2021,1,1,0,0,0,0,0,0,0.0,
35,Saqlain Sajib (BAN),2016-2016,1,1,0,0,0,0,0,0,0.0,
36,Saqib Naveed (EST),2021-2021,2,2,0,0,0,0,0,0,0.0,
37,Sazzad Hosen (Belg),2020-2021,6,6,0,0,0,0,0,0,0.0,
38,RM Scott (USA),2021-2021,2,2,0,0,0,0,0,0,0.0,
39,Scott Austin (CYP),2021-2021,4,4,0,0,0,0,0,0,0.0,
40,M Sedgwick (EST),2021-2021,3,3,0,0,0,0,0,0,0.0,
41,K Senamontree (THAI),2019-2019,2,2,0,0,0,0,0,0,0.0,
42,N Senamontree (THAI),2020-2020,4,4,0,0,0,0,0,0,0.0,
43,YSD Seneveratne (Caym),2019-2019,6,6,0,0,0,0,0,0,0.0,
44,S Sengupta (CZK-R),2021-2021,4,4,0,0,0,0,0,0,0.0,
45,M Sert (TKY),2019-2019,4,4,0,0,0,0,0,0,0.0,
46,Shabbir Ahmed (PAK),2007-2007,1,1,0,0,0,0,0,0,0.0,
47,Shabir Noori (AFG),2012-2012,1,1,0,0,0,0,0,0,0.0,
48,Shagharai Sefat (Belg),2021-2021,2,2,0,0,0,0,0,0,0.0,
49,Shahadat Hossain (BAN),2006-2013,6,6,0,0,0,0,0,0,0.0,
0,Shahbaz Badar (BHR),2019-2020,5,5,0,0,0,0,0,0,0.0,
1,Shohidul Islam (BAN),2021-2021,1,1,0,0,0,0,0,0,0.0,
2,Shahnawaz Dahani (PAK),2021-2021,2,2,0,0,0,0,0,0,0.0,
3,Shahzad Muhammad (Mex),2019-2019,2,2,0,0,0,0,0,0,0.0,
4,J Shaju (MLT),2021-2021,3,3,0,0,0,0,0,0,0.0,
5,Shakerullah Safi (DEN),2021-2021,4,4,0,0,0,0,0,0,0.0,
6,Sharif Asadullah (UAE),2014-2014,1,1,0,0,0,0,0,0,0.0,
7,KV Sharma (INDIA),2014-2014,1,1,0,0,0,0,0,0,0.0,
8,R Sharma (INDIA),2012-2012,2,2,0,0,0,0,0,0,0.0,
9,SM Sharma (UAE),2021-2021,1,1,0,0,0,0,0,0,0.0,
10,ZK Shem (VAN),2019-2019,5,5,0,0,0,0,0,0,0.0,
11,Shoaib Gazi Hossain (Chile),2019-2019,4,4,0,0,0,0,0,0,0.0,
12,PM Siddle (AUS),2009-2010,2,2,0,0,0,0,0,0,0.0,
13,KM Silva (),2019-2019,3,3,0,0,0,0,0,0,0.0,
14,BA Simango (MOZ),2019-2019,2,2,0,0,0,0,0,0,0.0,
15,M Simmons (BMUDA),2019-2021,6,6,0,0,0,0,0,0,0.0,
16,Simranjit Singh (ITA),2019-2019,1,1,0,0,0,0,0,0,0.0,
17,MS Sinclair (NZ),2005-2007,2,2,0,0,0,0,0,0,0.0,
18,S Singh (PHI),2019-2019,3,3,0,0,0,0,0,0,0.0,
19,S Singh (PORT),2019-2019,1,1,0,0,0,0,0,0,0.0,
20,JR Singleton (),2019-2019,3,3,0,0,0,0,0,0,0.0,
21,T Singye (BHU),2019-2019,2,2,0,0,0,0,0,0,0.0,
22,Sirajullah Khadim (PORT),2021-2021,4,4,0,0,0,0,0,0,0.0,
23,DC Smith (PHI),2019-2019,3,3,0,0,0,0,0,0,0.0,
24,RAJ Smith (SCOT),2019-2019,2,2,0,0,0,0,0,0,0.0,
25,Sohail Khan (PAK),2008-2017,5,5,0,0,0,0,0,0,0.0,
26,S Sohal (USA),2019-2019,3,3,0,0,0,0,0,0,0.0,
27,Soheel Hussain (Belg),2019-2019,1,1,0,0,0,0,0,0,0.0,
28,M Sohel Patel (PNM),2019-2021,7,7,0,0,0,0,0,0,0.0,
29,Sohrawordi Shuvo (BAN),2010-2010,1,1,0,0,0,0,0,0,0.0,
30,S Sola (Samoa),2019-2019,4,4,0,0,0,0,0,0,0.0,
31,S Soosiyakumar (BUL),2019-2019,1,1,0,0,0,0,0,0,0.0,
32,ES Soto (CRC),2019-2019,1,1,0,0,0,0,0,0,0.0,
33,M Spry (Peru),2019-2019,4,4,0,0,0,0,0,0,0.0,
34,BB Sran (INDIA),2016-2016,2,2,0,0,0,0,0,0,0.0,
35,L Sreekumar (UAE),2017-2017,1,1,0,0,0,0,0,0,0.0,
36,H Ssenyondo (UGA),2019-2021,24,24,0,0,0,0,0,0,0.0,
37,AJ Staal (NED),2019-2021,14,14,0,0,0,0,0,0,0.0,
38,B Stanlake (AUS),2017-2019,19,19,0,0,0,0,0,0,0.0,
39,AL Stephen (VAN),2019-2019,2,2,0,0,0,0,0,0,0.0,
40,BS Stephenson (Blz),2019-2021,9,9,0,0,0,0,0,0,0.0,
41,TJ Stephenson (Blz),2019-2021,4,4,0,0,0,0,0,0,0.0,
42,M Stoman (PORT),2021-2021,3,3,0,0,0,0,0,0,0.0,
43,O Stewart (Bhm),2021-2021,5,5,0,0,0,0,0,0,0.0,
44,GA Stuurman (SA),2021-2021,1,1,0,0,0,0,0,0,0.0,
45,K Subramanian (SGP),2020-2020,1,1,0,0,0,0,0,0,0.0,
46,Suhail Sadiq (LUX),2019-2019,2,2,0,0,0,0,0,0,0.0,
47,Suhrid Roy (MLT),2019-2021,2,2,0,0,0,0,0,0,0.0,
48,Sumair Khan (MLT),2019-2019,1,1,0,0,0,0,0,0,0.0,
49,Suresh Kumar (Peru),2019-2019,2,2,0,0,0,0,0,0,0.0,
0,ZE Surkari (CAN),2008-2008,4,4,0,0,0,0,0,0,0.0,
1,Syed Amanullah (GRC),2021-2021,3,3,0,0,0,0,0,0,0.0,
2,Tafseer Ali (NOR),2019-2019,5,5,0,0,0,0,0,0,0.0,
3,Taijul Islam (BAN),2019-2019,2,2,0,0,0,0,0,0,0.0,
4,Tanvir Ahmed (PAK),2010-2010,1,1,0,0,0,0,0,0,0.0,
5,S Tarawally (SLE),2021-2021,6,6,0,0,0,0,0,0,0.0,
6,Tariq Aziz (PORT),2019-2019,4,4,0,0,0,0,0,0,0.0,
7,Tarun Sharma (Mex),2019-2019,8,8,0,0,0,0,0,0,0.0,
8,Tejwinder Singh (CYP),2021-2021,6,6,0,0,0,0,0,0,0.0,
9,R Telemachus (SA),2006-2007,3,3,0,0,0,0,0,0,0.0,
10,VE Tembo (MOZ),2019-2021,8,8,0,0,0,0,0,0,0.0,
11,S Thakur (ROM),2021-2021,3,3,0,0,0,0,0,0,0.0,
12,TG Thamae (LES),2021-2021,5,5,0,0,0,0,0,0,0.0,
13,J Thinley (BHU),2019-2019,2,2,0,0,0,0,0,0,0.0,
14,AC Thomas (SA),2007-2007,1,1,0,0,0,0,0,0,0.0,
15,EP Thompson (NZ),2008-2008,1,1,0,0,0,0,0,0,0.0,
16,S Thuraisingam (CAN),2008-2008,3,3,0,0,0,0,0,0,0.0,
17,SF Tiai (Samoa),2019-2019,4,4,0,0,0,0,0,0,0.0,
18,KK Tillett (Blz),2021-2021,5,5,0,0,0,0,0,0,0.0,
19,AN Toube (CAM),2021-2021,4,4,0,0,0,0,0,0,0.0,
20,CT Tremlett (ENG),2007-2007,1,1,0,0,0,0,0,0,0.0,
21,AM Tribe (JER),2021-2021,5,5,0,0,0,0,0,0,0.0,
22,IJL Trott (ENG),2007-2010,6,6,0,0,0,0,0,0,0.0,
23,CK Tshuma (ZIM),2020-2020,1,1,0,0,0,0,0,0,0.0,
24,TE Tucker (BMUDA),2008-2008,1,1,0,0,0,0,0,0,0.0,
25,DR Tuffey (NZ),2005-2010,3,3,0,0,0,0,0,0,0.0,
26,T Turan (TKY),2019-2019,4,4,0,0,0,0,0,0,0.0,
27,HER Tyler (PHI),2019-2019,2,2,0,0,0,0,0,0,0.0,
28,ML Udawatte (SL),2008-2017,8,8,0,0,0,0,0,0,0.0,
29,T Ulutuna (TKY),2019-2019,3,3,0,0,0,0,0,0,0.0,
30,Umair Ali (UAE),2015-2015,3,3,0,0,0,0,0,0,0.0,
31,Umair Tariq (Aut),2021-2021,3,3,0,0,0,0,0,0,0.0,
32,J Umanath (Mex),2019-2019,7,7,0,0,0,0,0,0,0.0,
33,Usama Master (MWI),2019-2019,5,5,0,0,0,0,0,0,0.0,
34,Usman Khalid (Saudi),2021-2021,3,3,0,0,0,0,0,0,0.0,
35,Usman Mushtaq (UAE),2016-2016,3,3,0,0,0,0,0,0,0.0,
36,WPUJC Vaas (SL),2006-2007,6,6,0,0,0,0,0,0,0.0,
37,VL Mukesh (SEY),2021-2021,5,5,0,0,0,0,0,0,0.0,
38,VM Vaghela (USA),2021-2021,1,1,0,0,0,0,0,0,0.0,
39,JJ van der Wath (SA),2006-2007,8,8,0,0,0,0,0,0,0.0,
40,VB van Jaarsveld (SA),2009-2009,3,3,0,0,0,0,0,0,0.0,
41,S Varathappan (KUW),2019-2019,3,3,0,0,0,0,0,0,0.0,
42,CV Varun (INDIA),2021-2021,6,6,0,0,0,0,0,0,0.0,
43,S Vats (LUX),2020-2021,5,5,0,0,0,0,0,0,0.0,
44,MP Vaughan (ENG),2005-2007,2,2,0,0,0,0,0,0,0.0,
45,G Venkateswaran (LUX),2019-2021,5,5,0,0,0,0,0,0,0.0,
46,Vikramjit Singh (NED),2019-2021,2,2,0,0,0,0,0,0,0.0,
47,DJ Vilas (SA),2012-2012,1,1,0,0,0,0,0,0,0.0,
48,TC Vine (ESP),2019-2021,10,10,0,0,0,0,0,0,0.0,
49,R Vishwanath (LUX),2019-2021,5,5,0,0,0,0,0,0,0.0,
