,Player,Span,Mat,Inns,Dis,Ct,St,Ct Wk,Ct Fi,MD,D/I,Unnamed: 11
0,MV Boucher (ICC/SA),1997-2012,147,281,555,532,23,532,0,6 (6ct 0st),1.975,
1,AC Gilchrist (AUS),1999-2008,96,191,416,379,37,379,0,5 (5ct 0st),2.178,
2,IA Healy (AUS),1988-1999,119,224,395,366,29,366,0,6 (6ct 0st),1.763,
3,RW Marsh (AUS),1970-1984,96,182,355,343,12,343,0,6 (6ct 0st),1.95,
4,MS Dhoni (INDIA),2005-2014,90,166,294,256,38,256,0,6 (6ct 0st),1.771,
5,AJ Stewart (ENG),1990-2003,133,231,277,263,14,227,36,6 (6ct 0st),1.199,
6,BJ Watling (NZ),2009-2021,75,143,275,267,8,257,10,6 (6ct 0st),1.923,
7,PJL Dujon (WI),1981-1991,81,154,272,267,5,265,2,5 (5ct 0st),1.766,
8,BJ Haddin (AUS),2008-2015,66,128,270,262,8,262,0,6 (6ct 0st),2.109,
9,APE Knott (ENG),1967-1981,95,174,269,250,19,250,0,5 (4ct 1st),1.545,
10,MJ Prior (ENG),2007-2014,79,146,256,243,13,243,0,6 (6ct 0st),1.753,
11,Q de Kock (SA),2014-2021,54,101,232,221,11,221,0,6 (6ct 0st),2.297,
12,Wasim Bari (PAK),1967-1984,81,146,228,201,27,201,0,7 (7ct 0st),1.561,
13,AB de Villiers (SA),2004-2018,114,217,227,222,5,101,121,6 (6ct 0st),1.046,
14,TG Evans (ENG),1946-1959,91,175,219,173,46,173,0,4 (4ct 0st),1.251,
15,RD Jacobs (WI),1998-2004,65,122,219,207,12,207,0,7 (7ct 0st),1.795,
16,D Ramdin (WI),2005-2016,74,131,217,205,12,205,0,5 (5ct 0st),1.656,
17,R Dravid (ICC/INDIA),1996-2012,164,301,210,210,0,0,210,3 (3ct 0st),0.697,
18,JM Bairstow (ENG),2012-2022,80,150,209,196,13,178,18,6 (6ct 0st),1.393,
19,BB McCullum (NZ),2004-2016,101,186,209,198,11,168,30,5 (5ct 0st),1.123,
20,Kamran Akmal (PAK),2002-2010,53,99,206,184,22,184,0,5 (5ct 0st),2.08,
21,DPMD Jayawardene (SL),1997-2014,149,270,205,205,0,0,205,4 (4ct 0st),0.759,
22,AC Parore (NZ),1990-2002,78,138,204,197,7,194,3,5 (5ct 0st),1.478,
23,KC Sangakkara (SL),2000-2015,134,248,202,182,20,131,51,5 (5ct 0st),0.814,
24,JH Kallis (ICC/SA),1995-2013,166,315,200,200,0,0,200,4 (4ct 0st),0.634,
25,SMH Kirmani (INDIA),1976-1986,88,151,198,160,38,160,0,6 (5ct 1st),1.311,
26,RT Ponting (AUS),1995-2012,168,328,196,196,0,0,196,3 (3ct 0st),0.597,
27,DL Murray (WI),1963-1980,62,119,189,181,8,181,0,5 (5ct 0st),1.588,
28,ATW Grout (AUS),1957-1966,51,98,187,163,24,163,0,6 (6ct 0st),1.908,
29,ME Waugh (AUS),1991-2002,128,245,181,181,0,0,181,4 (4ct 0st),0.738,
30,IDS Smith (NZ),1980-1992,63,109,176,168,8,168,0,7 (7ct 0st),1.614,
31,AN Cook (ENG),2006-2018,161,300,175,175,0,0,175,3 (3ct 0st),0.583,
32,RW Taylor (ENG),1971-1984,57,106,174,167,7,167,0,7 (7ct 0st),1.641,
33,SP Fleming (NZ),1994-2008,111,199,171,171,0,0,171,5 (5ct 0st),0.859,
34,GC Smith (ICC/SA),2002-2014,117,225,169,169,0,0,169,5 (5ct 0st),0.751,
35,Sarfaraz Ahmed (PAK),2010-2019,49,94,167,146,21,146,0,5 (5ct 0st),1.776,
36,RC Russell (ENG),1988-1998,54,96,165,153,12,153,0,6 (6ct 0st),1.718,
37,BC Lara (ICC/WI),1990-2006,131,241,164,164,0,0,164,4 (4ct 0st),0.68,
38,LRPL Taylor (NZ),2007-2022,112,212,163,163,0,0,163,3 (3ct 0st),0.768,
39,A Flower (ZIM),1992-2002,63,110,160,151,9,142,9,5 (5ct 0st),1.454,
40,TD Paine (AUS),2010-2021,35,68,157,150,7,150,0,5 (5ct 0st),2.308,
41,MA Taylor (AUS),1989-1999,104,197,157,157,0,0,157,4 (4ct 0st),0.796,
42,AR Border (AUS),1978-1994,156,277,156,156,0,0,156,4 (4ct 0st),0.563,
43,HAPW Jayawardene (SL),2000-2015,58,102,156,124,32,124,0,5 (5ct 0st),1.529,
44,JC Buttler (ENG),2014-2022,57,108,154,153,1,130,23,5 (5ct 0st),1.425,
45,DJ Richardson (SA),1992-1998,42,77,152,150,2,150,0,5 (5ct 0st),1.974,
46,Moin Khan (PAK),1990-2004,69,124,148,128,20,127,1,5 (4ct 1st),1.193,
47,JE Root (ENG),2012-2022,114,215,148,148,0,0,148,4 (4ct 0st),0.688,
48,JHB Waite (SA),1951-1965,50,94,141,124,17,124,0,4 (4ct 0st),1.5,
49,Younis Khan (PAK),2000-2017,118,221,139,139,0,0,139,4 (4ct 0st),0.628,
0,N Dickwella (SL),2014-2021,45,82,135,112,23,111,1,5 (5ct 0st),1.646,
1,VVS Laxman (INDIA),1996-2012,134,248,135,135,0,0,135,4 (4ct 0st),0.544,
2,MJ Clarke (AUS),2004-2015,115,223,134,134,0,0,134,3 (3ct 0st),0.6,
3,SPD Smith (AUS),2010-2022,82,157,134,134,0,0,134,5 (5ct 0st),0.853,
4,GO Jones (ENG),2004-2006,34,66,133,128,5,128,0,6 (6ct 0st),2.015,
5,KS More (INDIA),1986-1993,49,90,130,110,20,110,0,5 (0ct 5st),1.444,
6,WAS Oldfield (AUS),1920-1937,54,101,130,78,52,78,0,5 (1ct 4st),1.287,
7,Rashid Latif (PAK),1992-2003,37,69,130,119,11,119,0,6 (6ct 0st),1.884,
8,ML Hayden (AUS),1994-2009,103,205,128,128,0,0,128,4 (4ct 0st),0.624,
9,SK Warne (AUS),1992-2007,145,281,125,125,0,0,125,3 (3ct 0st),0.444,
10,HP Tillakaratne (SL),1989-2004,83,141,124,122,2,33,89,5 (5ct 0st),0.879,
11,GS Chappell (AUS),1970-1984,87,165,122,122,0,0,122,4 (4ct 0st),0.739,
12,Mushfiqur Rahim (BAN),2005-2022,78,134,122,107,15,98,9,5 (5ct 0st),0.91,
13,IVA Richards (WI),1974-1991,121,232,122,122,0,0,122,4 (4ct 0st),0.525,
14,AJ Strauss (ENG),2004-2012,100,189,121,121,0,0,121,3 (3ct 0st),0.64,
15,IT Botham (ENG),1977-1992,102,179,120,120,0,0,120,3 (3ct 0st),0.67,
16,MC Cowdrey (ENG),1954-1975,114,214,120,120,0,0,120,3 (3ct 0st),0.56,
17,RS Kaluwitharana (SL),1992-2004,49,87,119,93,26,93,0,5 (5ct 0st),1.367,
18,CL Hooper (WI),1987-2002,102,189,115,115,0,0,115,4 (4ct 0st),0.608,
19,SR Tendulkar (INDIA),1989-2013,200,366,115,115,0,0,115,3 (3ct 0st),0.314,
20,JM Parks (ENG),1954-1968,46,86,114,103,11,101,2,5 (5ct 0st),1.325,
21,SR Waugh (AUS),1985-2004,168,318,112,112,0,0,112,3 (3ct 0st),0.352,
22,WR Hammond (ENG),1927-1947,85,154,110,110,0,0,110,3 (3ct 0st),0.714,
23,RR Pant (INDIA),2018-2022,28,55,110,102,8,102,0,6 (6ct 0st),2.0,
24,RB Simpson (AUS),1957-1978,62,117,110,110,0,0,110,4 (4ct 0st),0.94,
25,GS Sobers (WI),1954-1974,93,172,109,109,0,0,109,4 (4ct 0st),0.633,
26,HM Amla (SA),2004-2019,124,234,108,108,0,0,108,3 (3ct 0st),0.461,
27,SM Gavaskar (INDIA),1971-1987,125,216,108,108,0,0,108,3 (3ct 0st),0.5,
28,NR Mongia (INDIA),1994-2001,44,77,107,99,8,99,0,5 (5ct 0st),1.389,
29,M Azharuddin (INDIA),1984-2000,99,177,105,105,0,0,105,5 (5ct 0st),0.593,
30,IM Chappell (AUS),1964-1980,75,144,105,105,0,0,105,4 (4ct 0st),0.729,
31,GP Thorpe (ENG),1993-2005,100,179,105,105,0,0,105,4 (4ct 0st),0.586,
32,WP Saha (INDIA),2010-2021,40,77,104,92,12,92,0,6 (5ct 1st),1.35,
33,Saleem Yousuf (PAK),1982-1990,32,58,104,91,13,91,0,5 (5ct 0st),1.793,
34,GA Gooch (ENG),1975-1995,118,211,103,103,0,0,103,3 (3ct 0st),0.488,
35,JR Murray (WI),1993-2002,33,61,102,99,3,98,1,5 (5ct 0st),1.672,
36,IR Bell (ENG),2004-2015,118,223,100,100,0,0,100,3 (3ct 0st),0.448,
37,V Kohli (INDIA),2011-2022,99,189,100,100,0,0,100,3 (3ct 0st),0.529,
38,JM Anderson (ENG),2003-2022,169,319,99,99,0,0,99,3 (3ct 0st),0.31,
39,DC Boon (AUS),1984-1996,107,195,99,99,0,0,99,4 (4ct 0st),0.507,
40,AM Rahane (INDIA),2013-2022,82,157,99,99,0,0,99,5 (5ct 0st),0.63,
41,GRA Langley (AUS),1951-1956,26,51,98,83,15,83,0,5 (5ct 0st),1.921,
42,LEG Ames (ENG),1929-1939,47,87,97,74,23,72,2,4 (4ct 0st),1.114,
43,PD Collingwood (ENG),2003-2011,68,124,96,96,0,1,95,4 (4ct 0st),0.774,
44,CH Gayle (WI),2000-2014,103,190,96,96,0,0,96,3 (3ct 0st),0.505,
45,CG Greenidge (WI),1974-1991,108,208,96,96,0,0,96,3 (3ct 0st),0.461,
46,KJ Wadsworth (NZ),1969-1976,33,59,96,92,4,92,0,5 (5ct 0st),1.627,
47,ME Trescothick (ENG),2000-2006,76,139,95,95,0,0,95,4 (4ct 0st),0.683,
48,HH Gibbs (SA),1996-2008,90,173,94,94,0,0,94,4 (4ct 0st),0.543,
49,Javed Miandad (PAK),1976-1993,124,218,94,93,1,0,93,3 (3ct 0st),0.431,
0,Imtiaz Ahmed (PAK),1952-1962,41,69,93,77,16,74,3,5 (4ct 1st),1.347,
1,AFA Lilley (ENG),1896-1909,35,67,92,70,22,70,0,4 (4ct 0st),1.373,
2,V Sehwag (ICC/INDIA),2001-2013,104,192,91,91,0,0,91,3 (3ct 0st),0.473,
3,FCM Alexander (WI),1957-1961,25,47,90,85,5,85,0,5 (5ct 0st),1.914,
4,SO Dowrich (WI),2015-2020,35,61,90,85,5,85,0,4 (4ct 0st),1.475,
5,GA Hick (ENG),1991-2001,65,115,90,90,0,0,90,4 (4ct 0st),0.782,
6,CH Lloyd (WI),1966-1985,110,209,90,90,0,0,90,2 (2ct 0st),0.43,
7,RB Richardson (WI),1983-1995,86,164,90,90,0,0,90,3 (3ct 0st),0.548,
8,LD Chandimal (SL),2011-2021,64,119,89,79,10,63,16,6 (5ct 1st),0.747,
9,TM Dilshan (SL),1999-2013,87,159,88,88,0,11,77,4 (4ct 0st),0.553,
10,AW Greig (ENG),1972-1977,58,107,87,87,0,0,87,4 (4ct 0st),0.813,
11,Khaled Mashud (BAN),2000-2007,44,61,87,78,9,78,0,4 (4ct 0st),1.426,
12,MEK Hussey (AUS),2005-2013,79,153,85,85,0,0,85,3 (3ct 0st),0.555,
13,MS Wade (AUS),2012-2021,36,70,85,74,11,63,11,5 (4ct 1st),1.214,
14,BA Stokes (ENG),2013-2022,76,144,84,84,0,0,84,5 (5ct 0st),0.583,
15,MA Atherton (ENG),1989-2001,115,200,83,83,0,0,83,3 (3ct 0st),0.415,
16,G Kirsten (SA),1993-2004,101,191,83,83,0,0,83,4 (4ct 0st),0.434,
17,IR Redpath (AUS),1964-1976,66,123,83,83,0,0,83,3 (3ct 0st),0.674,
18,FM Engineer (INDIA),1961-1975,46,83,82,66,16,66,0,3 (3ct 0st),0.987,
19,CO Browne (WI),1995-2005,20,36,81,79,2,79,0,5 (5ct 0st),2.25,
20,Inzamam-ul-Haq (ICC/PAK),1992-2007,120,219,81,81,0,0,81,4 (4ct 0st),0.369,
21,TW Graveney (ENG),1951-1969,79,152,80,80,0,2,78,3 (3ct 0st),0.526,
22,D Elgar (SA),2012-2022,72,134,78,78,0,0,78,3 (3ct 0st),0.582,
23,ST Jayasuriya (SL),1991-2007,110,196,78,78,0,0,78,3 (3ct 0st),0.397,
24,DB Vengsarkar (INDIA),1976-1992,116,202,78,78,0,0,78,4 (4ct 0st),0.386,
25,Adnan Akmal (PAK),2010-2014,21,41,77,66,11,66,0,6 (6ct 0st),1.878,
26,Asad Shafiq (PAK),2010-2020,77,144,77,77,0,0,77,3 (3ct 0st),0.534,
27,PR Downton (ENG),1981-1988,30,51,75,70,5,70,0,4 (4ct 0st),1.47,
28,AJ Lamb (ENG),1982-1992,79,146,75,75,0,0,75,4 (4ct 0st),0.513,
29,DI Gower (ENG),1978-1992,117,211,74,74,0,0,74,3 (3ct 0st),0.35,
30,TWM Latham (NZ),2014-2022,63,122,74,74,0,7,67,4 (4ct 0st),0.606,
31,DA Warner (AUS),2011-2022,91,176,74,74,0,1,73,4 (4ct 0st),0.42,
32,JL Langer (AUS),1993-2007,105,206,73,73,0,0,73,2 (2ct 0st),0.354,
33,H Strudwick (ENG),1910-1926,28,50,73,61,12,61,0,4 (2ct 2st),1.46,
34,M Muralitharan (ICC/SL),1992-2010,133,233,72,72,0,0,72,2 (2ct 0st),0.309,
35,PA Patel (INDIA),2002-2018,25,47,72,62,10,62,0,4 (4ct 0st),1.531,
36,SM Pollock (SA),1995-2008,108,205,72,72,0,0,72,3 (3ct 0st),0.351,
37,KS Williamson (NZ),2010-2021,86,163,72,72,0,0,72,3 (3ct 0st),0.441,
38,MD Crowe (NZ),1982-1995,77,130,71,71,0,0,71,4 (4ct 0st),0.546,
39,SC Ganguly (INDIA),1996-2008,113,208,71,71,0,0,71,3 (3ct 0st),0.341,
40,BKG Mendis (SL),2015-2021,47,85,71,71,0,5,66,4 (4ct 0st),0.835,
41,NJ Astle (NZ),1996-2006,81,147,70,70,0,0,70,2 (2ct 0st),0.476,
42,Majid Khan (PAK),1964-1983,63,116,70,70,0,5,65,4 (4ct 0st),0.603,
43,AD Mathews (SL),2009-2021,92,168,69,69,0,0,69,3 (3ct 0st),0.41,
44,DJ Cullinan (SA),1993-2001,70,130,67,67,0,0,67,3 (3ct 0st),0.515,
45,N Hussain (ENG),1990-2004,96,165,67,67,0,0,67,3 (3ct 0st),0.406,
46,S Chanderpaul (WI),1994-2015,164,297,66,66,0,0,66,2 (2ct 0st),0.222,
47,Azhar Ali (PAK),2010-2021,91,170,65,65,0,0,65,3 (3ct 0st),0.382,
48,R Benaud (AUS),1952-1964,63,122,65,65,0,0,65,3 (3ct 0st),0.532,
49,H Carter (AUS),1907-1921,28,55,65,44,21,44,0,4 (4ct 0st),1.181,
0,DL Haynes (WI),1978-1994,116,221,65,65,0,0,65,2 (2ct 0st),0.294,
1,Mohammad Yousuf (PAK),1998-2010,90,168,65,65,0,0,65,3 (3ct 0st),0.386,
2,Saleem Malik (PAK),1982-1999,103,184,65,65,0,0,65,3 (3ct 0st),0.353,
3,DJG Sammy (WI),2007-2013,38,68,65,65,0,0,65,5 (5ct 0st),0.955,
4,JV Coney (NZ),1974-1987,52,97,64,64,0,0,64,3 (3ct 0st),0.659,
5,RN Harvey (AUS),1948-1963,79,152,64,64,0,0,64,4 (4ct 0st),0.421,
6,N Kapil Dev (INDIA),1978-1994,131,230,64,64,0,0,64,2 (2ct 0st),0.278,
7,CA Pujara (INDIA),2010-2022,95,183,64,64,0,0,64,3 (3ct 0st),0.349,
8,FS Trueman (ENG),1952-1965,67,128,64,64,0,0,64,3 (3ct 0st),0.5,
9,CL Walcott (WI),1948-1960,44,82,64,53,11,27,26,4 (3ct 1st),0.78,
10,FE Woolley (ENG),1909-1934,64,113,64,64,0,1,63,4 (4ct 0st),0.566,
11,F du Plessis (SA),2012-2021,69,128,63,63,0,0,63,3 (3ct 0st),0.492,
12,KD Karthik (INDIA),2004-2018,26,49,63,57,6,51,6,4 (4ct 0st),1.285,
13,JJ Kelly (AUS),1896-1905,36,67,63,43,20,43,0,4 (4ct 0st),0.94,
14,PM Nevill (AUS),2015-2016,17,31,63,61,2,61,0,4 (4ct 0st),2.032,
15,GR Viswanath (INDIA),1969-1983,91,159,63,63,0,0,63,3 (3ct 0st),0.396,
16,RC Fredericks (WI),1968-1977,59,112,62,62,0,0,62,4 (4ct 0st),0.553,
17,DA Murray (WI),1978-1982,19,34,62,57,5,57,0,5 (5ct 0st),1.823,
18,KP Pietersen (ENG),2005-2014,104,193,62,62,0,0,62,3 (3ct 0st),0.321,
19,T Taibu (ZIM),2001-2012,28,42,62,57,5,55,2,4 (4ct 0st),1.476,
20,JM Blackham (AUS),1877-1894,35,62,61,37,24,35,2,4 (2ct 2st),0.983,
21,MA Butcher (ENG),1997-2004,71,122,61,61,0,0,61,3 (3ct 0st),0.5,
22,TG Southee (NZ),2008-2022,83,159,61,61,0,0,61,2 (2ct 0st),0.383,
23,ADR Campbell (ZIM),1992-2002,60,105,60,60,0,0,60,3 (3ct 0st),0.571,
24,G Duckworth (ENG),1924-1936,24,43,60,45,15,45,0,4 (4ct 0st),1.395,
25,A Kumble (INDIA),1990-2008,132,242,60,60,0,0,60,2 (2ct 0st),0.247,
26,W Rhodes (ENG),1899-1930,58,110,60,60,0,0,60,4 (4ct 0st),0.545,
27,HB Taber (AUS),1966-1970,16,30,60,56,4,56,0,5 (5ct 0st),2.0,
28,MW Gatting (ENG),1978-1995,79,135,59,59,0,0,59,3 (3ct 0st),0.437,
29,WK Lees (NZ),1976-1983,21,42,59,52,7,52,0,5 (5ct 0st),1.404,
30,DT Lindsay (SA),1963-1970,19,36,59,57,2,54,3,6 (6ct 0st),1.638,
31,GAR Lock (ENG),1952-1968,49,93,59,59,0,0,59,3 (3ct 0st),0.634,
32,MS Atapattu (SL),1990-2007,90,159,58,58,0,0,58,3 (3ct 0st),0.364,
33,KF Barrington (ENG),1955-1968,82,153,58,58,0,0,58,3 (3ct 0st),0.379,
34,Liton Das (BAN),2015-2022,29,44,58,53,5,46,7,4 (4ct 0st),1.318,
35,D Tallon (AUS),1946-1953,21,42,58,50,8,50,0,4 (4ct 0st),1.38,
36,DL Vettori (ICC/NZ),1997-2014,113,205,58,58,0,0,58,3 (3ct 0st),0.282,
37,L Hutton (ENG),1937-1955,79,147,57,57,0,0,57,3 (3ct 0st),0.387,
38,AL Logie (WI),1983-1991,52,98,57,57,0,0,57,4 (4ct 0st),0.581,
39,RS Mahanama (SL),1986-1998,52,81,56,56,0,0,56,4 (4ct 0st),0.691,
40,B Mitchell (SA),1929-1949,42,71,56,56,0,0,56,4 (4ct 0st),0.788,
41,JO Holder (WI),2014-2021,53,93,55,55,0,0,55,3 (3ct 0st),0.591,
42,FDM Karunaratne (SL),2012-2021,74,137,55,55,0,0,55,3 (3ct 0st),0.401,
43,JT Murray (ENG),1961-1967,21,38,55,52,3,52,0,6 (6ct 0st),1.447,
44,KWR Fletcher (ENG),1968-1982,59,106,54,54,0,0,54,3 (3ct 0st),0.509,
45,SD Hope (WI),2015-2021,38,69,54,53,1,9,44,5 (5ct 0st),0.782,
46,BN Jarman (AUS),1959-1969,19,36,54,50,4,50,0,4 (4ct 0st),1.5,
47,NM Lyon (AUS),2011-2022,105,204,54,54,0,0,54,2 (2ct 0st),0.264,
48,ND McKenzie (SA),2000-2009,58,111,54,54,0,0,54,3 (3ct 0st),0.486,
49,Mohammad Rizwan (PAK),2016-2021,19,32,54,52,2,51,1,4 (4ct 0st),1.687,
0,CMW Read (ENG),1999-2007,15,26,54,48,6,48,0,6 (6ct 0st),2.076,
1,GP Swann (ENG),2008-2013,60,113,54,54,0,0,54,3 (3ct 0st),0.477,
2,BA Young (NZ),1993-1999,35,58,54,54,0,0,54,3 (3ct 0st),0.931,
3,RR Sarwan (WI),2000-2011,87,162,53,53,0,0,53,2 (2ct 0st),0.327,
4,MJK Smith (ENG),1958-1972,50,91,53,53,0,0,53,3 (3ct 0st),0.582,
5,ED Solkar (INDIA),1969-1977,27,50,53,53,0,0,53,4 (4ct 0st),1.06,
6,JM Brearley (ENG),1976-1981,39,75,52,52,0,0,52,3 (3ct 0st),0.693,
7,A Flintoff (ENG/ICC),1998-2009,79,144,52,52,0,0,52,3 (3ct 0st),0.361,
8,LR Gibbs (WI),1958-1976,79,151,52,52,0,0,52,3 (3ct 0st),0.344,
9,WB Phillips (AUS),1983-1986,27,43,52,52,0,43,9,5 (5ct 0st),1.209,
10,RP Arnold (SL),1997-2004,44,77,51,51,0,0,51,4 (4ct 0st),0.662,
11,DM Bravo (WI),2010-2020,56,96,51,51,0,0,51,5 (5ct 0st),0.531,
12,SCJ Broad (ENG),2007-2022,152,286,51,51,0,0,51,2 (2ct 0st),0.178,
13,HB Cameron (SA),1927-1935,26,45,51,39,12,39,0,4 (2ct 2st),1.133,
14,RW Chakabva (ZIM),2011-2021,22,38,51,46,5,45,1,5 (5ct 0st),1.342,
15,AE Dick (NZ),1961-1965,17,30,51,47,4,47,0,4 (4ct 0st),1.7,
16,AI Kallicharran (WI),1972-1981,66,124,51,51,0,0,51,2 (2ct 0st),0.411,
17,NS Tamhane (INDIA),1955-1961,21,35,51,35,16,35,0,4 (4ct 0st),1.457,
18,MJ Guptill (NZ),2009-2016,47,88,50,50,0,0,50,3 (3ct 0st),0.568,
19,KJ Hughes (AUS),1977-1984,70,126,50,50,0,0,50,3 (3ct 0st),0.396,
20,RB Kanhai (WI),1957-1974,79,147,50,50,0,6,44,3 (3ct 0st),0.34,
21,Misbah-ul-Haq (PAK),2001-2017,75,143,50,50,0,0,50,3 (3ct 0st),0.349,
22,KL Rahul (INDIA),2014-2022,43,83,50,50,0,1,49,4 (4ct 0st),0.602,
23,DCS Compton (ENG),1937-1957,78,146,49,49,0,0,49,2 (2ct 0st),0.335,
24,BM McMillan (SA),1992-1998,38,70,49,49,0,0,49,3 (3ct 0st),0.7,
25,SJ Rhodes (ENG),1994-1995,11,22,49,46,3,46,0,4 (4ct 0st),2.227,
26,M Vijay (INDIA),2008-2018,61,115,49,49,0,0,49,2 (2ct 0st),0.426,
27,ED Weekes (WI),1948-1958,48,90,49,49,0,0,49,4 (4ct 0st),0.544,
28,JC Adams (WI),1992-2001,54,99,48,48,0,0,48,4 (4ct 0st),0.484,
29,CS Baugh (WI),2003-2012,21,38,48,43,5,43,0,5 (4ct 1st),1.263,
30,TL Goddard (SA),1955-1970,41,77,48,48,0,0,48,4 (4ct 0st),0.623,
31,Mudassar Nazar (PAK),1976-1989,76,133,48,48,0,0,48,2 (2ct 0st),0.36,
32,Taufeeq Umar (PAK),2001-2014,44,83,48,48,0,4,44,4 (4ct 0st),0.578,
33,M Amarnath (INDIA),1969-1988,69,115,47,47,0,0,47,3 (3ct 0st),0.408,
34,SL Campbell (WI),1995-2002,52,92,47,47,0,0,47,3 (3ct 0st),0.51,
35,JL Hendriks (WI),1962-1969,20,37,47,42,5,42,0,4 (2ct 2st),1.27,
36,AG Prince (SA),2002-2011,66,124,47,47,0,0,47,3 (3ct 0st),0.379,
37,A Ranatunga (SL),1982-2000,93,148,47,47,0,0,47,3 (3ct 0st),0.317,
38,SJ Rixon (AUS),1977-1985,13,24,47,42,5,42,0,4 (4ct 0st),1.958,
39,KR Stackpole (AUS),1966-1974,43,83,47,47,0,0,47,3 (3ct 0st),0.566,
40,DM de Silva (SL),2016-2021,38,69,46,46,0,0,46,4 (4ct 0st),0.666,
41,AL Wadekar (INDIA),1966-1974,37,69,46,46,0,0,46,4 (4ct 0st),0.666,
42,GS Blewett (AUS),1995-2000,46,90,45,45,0,0,45,3 (3ct 0st),0.5,
43,Ijaz Ahmed (PAK),1987-2001,60,110,45,45,0,0,45,3 (3ct 0st),0.409,
44,R Illingworth (ENG),1958-1973,61,115,45,45,0,0,45,3 (3ct 0st),0.391,
45,Mohammad Hafeez (PAK),2003-2018,55,107,45,45,0,0,45,2 (2ct 0st),0.42,
46,TT Samaraweera (SL),2001-2013,81,145,45,45,0,0,45,3 (3ct 0st),0.31,
47,RG Sharma (INDIA),2013-2021,43,84,45,45,0,0,45,3 (3ct 0st),0.535,
48,H Trumble (AUS),1890-1904,32,61,45,45,0,0,45,3 (3ct 0st),0.737,
49,SR Watson (AUS),2005-2015,59,113,45,45,0,0,45,3 (3ct 0st),0.398,
0,WW Armstrong (AUS),1902-1921,50,96,44,44,0,0,44,2 (2ct 0st),0.458,
1,BE Congdon (NZ),1965-1978,61,110,44,44,0,1,43,3 (3ct 0st),0.4,
2,JR Reid (NZ),1949-1965,58,90,44,43,1,4,39,3 (3ct 0st),0.488,
3,DL Underwood (ENG),1966-1982,86,157,44,44,0,0,44,3 (3ct 0st),0.28,
4,MP Vaughan (ENG),1999-2008,82,150,44,44,0,0,44,3 (3ct 0st),0.293,
5,S Venkataraghavan (INDIA),1965-1983,57,101,44,44,0,0,44,4 (4ct 0st),0.435,
6,Wasim Akram (PAK),1985-2002,104,186,44,44,0,0,44,3 (3ct 0st),0.236,
7,PA de Silva (SL),1984-2002,93,149,43,43,0,0,43,4 (4ct 0st),0.288,
8,JH Edrich (ENG),1963-1976,77,145,43,43,0,0,43,2 (2ct 0st),0.296,
9,GW Flower (ZIM),1992-2004,67,114,43,43,0,0,43,3 (3ct 0st),0.377,
10,AW Nourse (SA),1902-1924,45,78,43,43,0,0,43,4 (4ct 0st),0.551,
11,KD Walters (AUS),1965-1981,74,142,43,43,0,0,43,2 (2ct 0st),0.302,
12,FMM Worrell (WI),1948-1963,51,98,43,43,0,0,43,3 (3ct 0st),0.438,
13,AK Davidson (AUS),1953-1963,44,85,42,42,0,0,42,4 (4ct 0st),0.494,
14,PH Edmonds (ENG),1975-1987,51,91,42,42,0,0,42,4 (4ct 0st),0.461,
15,J Garner (WI),1977-1987,58,111,42,42,0,0,42,3 (3ct 0st),0.378,
16,Harbhajan Singh (INDIA),1998-2015,103,192,42,42,0,0,42,2 (2ct 0st),0.218,
17,Iqbal Qasim (PAK),1976-1988,50,89,42,42,0,0,42,3 (3ct 0st),0.471,
18,PBH May (ENG),1951-1961,66,127,42,42,0,0,42,4 (4ct 0st),0.33,
19,Mushtaq Mohammad (PAK),1959-1979,57,102,42,42,0,0,42,2 (2ct 0st),0.411,
20,PH Parfitt (ENG),1961-1972,37,73,42,42,0,0,42,4 (4ct 0st),0.575,
21,GM Turner (NZ),1969-1983,41,75,42,42,0,0,42,2 (2ct 0st),0.56,
22,D Williams (WI),1992-1998,11,19,42,40,2,40,0,5 (5ct 0st),2.21,
23,DJ Bravo (WI),2004-2010,40,71,41,41,0,0,41,3 (3ct 0st),0.577,
24,JJ Crowe (NZ),1983-1990,39,69,41,41,0,0,41,4 (4ct 0st),0.594,
25,WR Endean (SA),1951-1958,28,52,41,41,0,3,38,3 (3ct 0st),0.788,
26,SJ McCabe (AUS),1930-1938,39,73,41,41,0,0,41,3 (3ct 0st),0.561,
27,GM Wood (AUS),1978-1988,59,108,41,41,0,0,41,2 (2ct 0st),0.379,
28,MM Ali (ENG),2014-2021,64,121,40,40,0,0,40,4 (4ct 0st),0.33,
29,TA Boult (NZ),2011-2022,75,143,40,40,0,0,40,2 (2ct 0st),0.279,
30,J Da Silva (WI),2020-2021,11,20,40,38,2,38,0,4 (4ct 0st),2.0,
31,Hanif Mohammad (PAK),1952-1969,55,95,40,40,0,2,38,4 (4ct 0st),0.421,
32,Imran Farhat (PAK),2001-2013,40,72,40,40,0,0,40,2 (2ct 0st),0.555,
33,K Srikkanth (INDIA),1981-1992,43,78,40,40,0,0,40,5 (5ct 0st),0.512,
34,LC Braund (ENG),1901-1908,23,44,39,39,0,0,39,4 (4ct 0st),0.886,
35,WJ Edrich (ENG),1938-1955,39,70,39,39,0,0,39,3 (3ct 0st),0.557,
36,BN French (ENG),1986-1988,16,25,39,38,1,38,0,4 (4ct 0st),1.56,
37,WG Grace (ENG),1880-1899,22,42,39,39,0,1,38,3 (3ct 0st),0.928,
38,Sir RJ Hadlee (NZ),1973-1990,86,156,39,39,0,0,39,2 (2ct 0st),0.25,
39,RA Jadeja (INDIA),2012-2021,57,110,39,39,0,0,39,3 (3ct 0st),0.354,
40,SM Katich (AUS),2001-2010,56,109,39,39,0,0,39,2 (2ct 0st),0.357,
41,Mahmudullah (BAN),2009-2021,50,87,39,38,1,0,38,3 (3ct 0st),0.448,
42,MR Ramprakash (ENG),1991-2002,52,93,39,39,0,0,39,3 (3ct 0st),0.419,
43,RA Smith (ENG),1988-1996,62,110,39,39,0,0,39,3 (3ct 0st),0.354,
44,RGD Willis (ENG),1971-1984,90,165,39,39,0,0,39,2 (2ct 0st),0.236,
45,CPS Chauhan (INDIA),1969-1981,40,71,38,38,0,0,38,3 (3ct 0st),0.535,
46,JP Duminy (SA),2008-2017,46,83,38,38,0,0,38,3 (3ct 0st),0.457,
47,G Gambhir (INDIA),2004-2016,58,104,38,38,0,0,38,2 (2ct 0st),0.365,
48,GD McGrath (AUS),1993-2007,124,244,38,38,0,0,38,2 (2ct 0st),0.155,
49,GR Marsh (AUS),1985-1992,50,89,38,38,0,0,38,2 (2ct 0st),0.426,
0,KR Miller (AUS),1946-1956,55,105,38,38,0,0,38,2 (2ct 0st),0.361,
1,JG Wright (NZ),1978-1993,82,145,38,38,0,0,38,3 (3ct 0st),0.262,
2,CG Borde (INDIA),1958-1969,55,96,37,37,0,0,37,3 (3ct 0st),0.385,
3,JM Gregory (AUS),1920-1928,24,44,37,37,0,0,37,3 (3ct 0st),0.84,
4,UT Khawaja (AUS),2011-2022,46,87,37,37,0,0,37,3 (3ct 0st),0.425,
5,Aamer Sohail (PAK),1992-2000,47,87,36,36,0,0,36,3 (3ct 0st),0.413,
6,Asif Iqbal (PAK),1964-1980,58,110,36,36,0,0,36,2 (2ct 0st),0.327,
7,RA Harper (WI),1983-1993,25,49,36,36,0,0,36,3 (3ct 0st),0.734,
8,AC Hudson (SA),1992-1998,35,63,36,36,0,0,36,4 (4ct 0st),0.571,
9,DR Martyn (AUS),1992-2006,67,130,36,36,0,0,36,2 (2ct 0st),0.276,
10,RJ Shastri (INDIA),1981-1992,80,140,36,36,0,0,36,2 (2ct 0st),0.257,
11,PW Sherwell (SA),1906-1911,13,24,36,20,16,20,0,3 (3ct 0st),1.5,
12,DS Smith (WI),2003-2018,43,79,36,36,0,0,36,3 (3ct 0st),0.455,
13,EJ Barlow (SA),1961-1970,30,58,35,35,0,0,35,3 (3ct 0st),0.603,
14,Imrul Kayes (BAN),2008-2019,39,67,35,35,0,5,30,5 (5ct 0st),0.522,
15,GRJ Roope (ENG),1973-1978,21,37,35,35,0,0,35,3 (3ct 0st),0.945,
16,JK Silva (SL),2011-2018,39,75,35,34,1,6,28,2 (2ct 0st),0.466,
17,FJ Titmus (ENG),1955-1975,53,100,35,35,0,0,35,2 (2ct 0st),0.35,
18,KJ Wright (AUS),1979-1979,10,16,35,31,4,31,0,5 (5ct 0st),2.187,
19,J Blackwood (WI),2014-2021,43,74,34,34,0,0,34,5 (5ct 0st),0.459,
20,KC Brathwaite (WI),2011-2021,74,131,34,34,0,0,34,2 (2ct 0st),0.259,
21,MG Burgess (NZ),1968-1980,50,94,34,34,0,0,34,2 (2ct 0st),0.361,
22,SV Carlisle (ZIM),1995-2005,37,62,34,34,0,0,34,3 (3ct 0st),0.548,
23,SS Das (INDIA),2000-2002,23,43,34,34,0,0,34,3 (3ct 0st),0.79,
24,JE Emburey (ENG),1978-1995,64,109,34,34,0,0,34,2 (2ct 0st),0.311,
25,DM Jones (AUS),1984-1992,52,91,34,34,0,0,34,2 (2ct 0st),0.373,
26,L Klusener (SA),1996-2004,49,92,34,34,0,0,34,2 (2ct 0st),0.369,
27,GD McKenzie (AUS),1961-1971,60,113,34,34,0,0,34,2 (2ct 0st),0.3,
28,Mohsin Khan (PAK),1978-1986,48,83,34,34,0,0,34,3 (3ct 0st),0.409,
29,Ramiz Raja (PAK),1984-1997,57,103,34,34,0,0,34,3 (3ct 0st),0.33,
30,JN Rhodes (SA),1992-2000,52,96,34,34,0,0,34,2 (2ct 0st),0.354,
31,SAR Silva (SL),1983-1988,9,15,34,33,1,33,0,6 (6ct 0st),2.266,
32,HDRL Thirimanne (SL),2011-2021,42,79,34,34,0,0,34,5 (5ct 0st),0.43,
33,Zaheer Abbas (PAK),1969-1985,78,139,34,34,0,0,34,3 (3ct 0st),0.244,
34,G Boycott (ENG),1964-1982,108,193,33,33,0,0,33,2 (2ct 0st),0.17,
35,WJ Cronje (SA),1992-2000,68,128,33,33,0,0,33,2 (2ct 0st),0.257,
36,AF Giles (ENG),1998-2006,54,99,33,33,0,0,33,2 (2ct 0st),0.333,
37,AP Gurusinha (SL),1985-1996,41,66,33,33,0,2,31,2 (2ct 0st),0.5,
38,EH Hendren (ENG),1920-1935,51,92,33,33,0,0,33,2 (2ct 0st),0.358,
39,C Hill (AUS),1896-1912,49,93,33,33,0,0,33,3 (3ct 0st),0.354,
40,HJ Howarth (NZ),1969-1977,30,55,33,33,0,0,33,3 (3ct 0st),0.6,
41,MH Mankad (INDIA),1946-1959,44,72,33,33,0,0,33,3 (3ct 0st),0.458,
42,MJ Slater (AUS),1993-2001,74,143,33,33,0,0,33,4 (4ct 0st),0.23,
43,PR Umrigar (INDIA),1948-1962,59,101,33,33,0,0,33,3 (3ct 0st),0.326,
44,S Abid Ali (INDIA),1967-1974,29,53,32,32,0,0,32,3 (3ct 0st),0.603,
45,TE Bailey (ENG),1949-1959,61,118,32,32,0,0,32,2 (2ct 0st),0.271,
46,DG Bradman (AUS),1928-1948,52,99,32,32,0,0,32,2 (2ct 0st),0.323,
47,APF Chapman (ENG),1924-1931,26,46,32,32,0,0,32,4 (4ct 0st),0.695,
48,WW Hinds (WI),2000-2005,45,83,32,32,0,0,32,3 (3ct 0st),0.385,
49,KR Rutherford (NZ),1985-1995,56,95,32,32,0,0,32,2 (2ct 0st),0.336,
0,MA Starc (AUS),2011-2022,66,129,32,32,0,0,32,2 (2ct 0st),0.248,
1,TA Ward (SA),1912-1924,23,37,32,19,13,19,0,3 (3ct 0st),0.864,
2,TR Ambrose (ENG),2008-2009,11,21,31,31,0,31,0,3 (3ct 0st),1.476,
3,JG Bracewell (NZ),1980-1990,41,73,31,31,0,0,31,3 (3ct 0st),0.424,
4,JT Ikin (ENG),1946-1955,18,32,31,31,0,0,31,3 (3ct 0st),0.968,
5,AN Petersen (SA),2010-2015,36,68,31,31,0,0,31,2 (2ct 0st),0.455,
6,KOA Powell (WI),2011-2021,44,79,31,31,0,0,31,3 (3ct 0st),0.392,
7,DW Randall (ENG),1977-1984,47,88,31,31,0,0,31,2 (2ct 0st),0.352,
8,PK Sen (INDIA),1948-1952,14,21,31,20,11,20,0,4 (4ct 0st),1.476,
9,MS Sinclair (NZ),1999-2010,33,61,31,31,0,1,30,3 (3ct 0st),0.508,
10,VT Trumper (AUS),1899-1912,48,90,31,31,0,0,31,2 (2ct 0st),0.344,
11,WPUJC Vaas (SL),1994-2009,111,196,31,31,0,0,31,2 (2ct 0st),0.158,
12,B Yardley (AUS),1978-1983,33,62,31,31,0,0,31,2 (2ct 0st),0.5,
13,Yuvraj Singh (INDIA),2003-2012,40,76,31,31,0,0,31,2 (2ct 0st),0.407,
14,TA Blundell (NZ),2017-2022,15,30,30,29,1,26,3,4 (4ct 0st),1.0,
15,BL Cairns (NZ),1974-1985,43,78,30,30,0,0,30,2 (2ct 0st),0.384,
16,D Ganga (WI),1998-2008,48,87,30,30,0,0,30,3 (3ct 0st),0.344,
17,RG Hart (NZ),2002-2003,11,18,30,29,1,29,0,4 (4ct 0st),1.666,
18,AL Hassett (AUS),1938-1953,43,82,30,30,0,0,30,2 (2ct 0st),0.365,
19,IWG Johnson (AUS),1946-1956,45,86,30,30,0,0,30,3 (3ct 0st),0.348,
20,BK Kunderan (INDIA),1960-1967,18,31,30,23,7,21,2,5 (3ct 2st),0.967,
21,WM Lawry (AUS),1961-1971,67,127,30,30,0,0,30,2 (2ct 0st),0.236,
22,AA Mallett (AUS),1968-1980,38,73,30,30,0,0,30,2 (2ct 0st),0.41,
23,Mominul Haque (BAN),2013-2022,49,81,30,30,0,0,30,3 (3ct 0st),0.37,
24,FLH Mooney (NZ),1949-1954,14,23,30,22,8,22,0,4 (3ct 1st),1.304,
25,JM Parker (NZ),1973-1980,36,65,30,30,0,0,30,3 (3ct 0st),0.461,
26,BRM Taylor (ZIM),2004-2021,34,54,30,30,0,3,27,2 (2ct 0st),0.555,
27,H Verity (ENG),1931-1939,40,75,30,30,0,0,30,2 (2ct 0st),0.4,
28,KC Wessels (AUS/SA),1982-1994,40,70,30,30,0,0,30,2 (2ct 0st),0.428,
29,PR Adams (SA),1995-2004,45,85,29,29,0,0,29,3 (3ct 0st),0.341,
30,R Ashwin (INDIA),2011-2022,84,162,29,29,0,0,29,2 (2ct 0st),0.179,
31,JP Crawley (ENG),1994-2003,37,65,29,29,0,0,29,2 (2ct 0st),0.446,
32,ER Dexter (ENG),1958-1968,62,116,29,29,0,0,29,2 (2ct 0st),0.25,
33,BL D'Oliveira (ENG),1966-1972,44,83,29,29,0,0,29,3 (3ct 0st),0.349,
34,LK Germon (NZ),1995-1997,12,19,29,27,2,27,0,4 (4ct 0st),1.526,
35,GP Howarth (NZ),1975-1985,47,86,29,29,0,0,29,2 (2ct 0st),0.337,
36,AC MacLaren (ENG),1894-1909,35,64,29,29,0,0,29,2 (2ct 0st),0.453,
37,H Masakadza (ZIM),2001-2018,38,63,29,29,0,0,29,3 (3ct 0st),0.46,
38,JA Rudolph (SA),2003-2012,48,92,29,29,0,0,29,2 (2ct 0st),0.315,
39,A Shrewsbury snr (ENG),1881-1893,23,42,29,29,0,0,29,3 (3ct 0st),0.69,
40,IJL Trott (ENG),2009-2015,52,99,29,29,0,0,29,2 (2ct 0st),0.292,
41,CA Walsh (WI),1984-2001,132,244,29,29,0,0,29,2 (2ct 0st),0.118,
42,LN Constantine (WI),1928-1939,18,29,28,28,0,0,28,3 (3ct 0st),0.965,
43,MH Denness (ENG),1969-1975,28,50,28,28,0,0,28,2 (2ct 0st),0.56,
44,S Dhawan (INDIA),2013-2018,34,66,28,28,0,0,28,2 (2ct 0st),0.424,
45,PSP Handscomb (AUS),2016-2019,16,30,28,28,0,0,28,3 (3ct 0st),0.933,
46,Imran Khan (PAK),1971-1992,88,158,28,28,0,0,28,3 (3ct 0st),0.177,
47,GA Lohmann (ENG),1886-1896,18,36,28,28,0,0,28,3 (3ct 0st),0.777,
48,AK Markram (SA),2017-2022,29,57,28,28,0,0,28,3 (3ct 0st),0.491,
49,HM Nicholls (NZ),2016-2022,44,84,28,28,0,0,28,2 (2ct 0st),0.333,
0,Sadiq Mohammad (PAK),1969-1981,41,74,28,28,0,0,28,2 (2ct 0st),0.378,
1,MN Samuels (WI),2000-2016,71,127,28,28,0,0,28,2 (2ct 0st),0.22,
2,JB Statham (ENG),1951-1965,70,134,28,28,0,0,28,2 (2ct 0st),0.208,
3,TM Alderman (AUS),1981-1991,41,75,27,27,0,0,27,2 (2ct 0st),0.36,
4,J Darling (AUS),1894-1905,34,63,27,27,0,0,27,3 (3ct 0st),0.428,
5,HH Dippenaar (SA),1999-2007,38,72,27,27,0,0,27,2 (2ct 0st),0.375,
6,JN Gillespie (AUS),1996-2006,71,141,27,27,0,0,27,1 (1ct 0st),0.191,
7,MJ Greatbatch (NZ),1988-1996,41,64,27,27,0,0,27,3 (3ct 0st),0.421,
8,W Jaffer (INDIA),2000-2008,31,58,27,27,0,0,27,3 (3ct 0st),0.465,
9,MG Johnson (AUS),2007-2015,73,141,27,27,0,0,27,4 (4ct 0st),0.191,
10,PG Joshi (INDIA),1951-1960,12,20,27,18,9,18,0,4 (2ct 2st),1.35,
11,NT Paranavitana (SL),2009-2012,32,53,27,27,0,0,27,2 (2ct 0st),0.509,
12,MAK Pataudi (INDIA),1961-1975,46,84,27,27,0,0,27,2 (2ct 0st),0.321,
13,MDKJ Perera (SL),2015-2021,22,42,27,19,8,14,5,3 (3ct 0st),0.642,
14,CL Vincent (SA),1927-1935,25,43,27,27,0,0,27,2 (2ct 0st),0.627,
15,SC Williams (WI),1994-2002,31,53,27,27,0,0,27,2 (2ct 0st),0.509,
16,BS Bedi (INDIA),1966-1979,67,121,26,26,0,0,26,1 (1ct 0st),0.214,
17,AV Bedser (ENG),1946-1955,51,93,26,26,0,0,26,2 (2ct 0st),0.279,
18,DR Jardine (ENG),1928-1934,22,42,26,26,0,0,26,3 (3ct 0st),0.619,
19,NV Knight (ENG),1995-2001,17,31,26,26,0,0,26,4 (4ct 0st),0.838,
20,RR Lindwall (AUS),1946-1960,61,117,26,26,0,0,26,2 (2ct 0st),0.222,
21,SV Manjrekar (INDIA),1987-1996,37,68,26,25,1,0,25,3 (3ct 0st),0.382,
22,MA Noble (AUS),1898-1909,42,79,26,26,0,0,26,3 (3ct 0st),0.329,
23,MH Richardson (NZ),2000-2004,38,68,26,26,0,0,26,2 (2ct 0st),0.382,
24,Sarfraz Nawaz (PAK),1969-1984,55,98,26,26,0,0,26,3 (3ct 0st),0.265,
25,PV Simmons (WI),1988-1997,26,48,26,26,0,0,26,2 (2ct 0st),0.541,
26,DW Steyn (SA),2004-2019,93,175,26,26,0,0,26,2 (2ct 0st),0.148,
27,RF Surti (INDIA),1960-1969,26,47,26,26,0,0,26,3 (3ct 0st),0.553,
28,R Swetman (ENG),1959-1960,11,19,26,24,2,24,0,4 (4ct 0st),1.368,
29,HJ Tayfield (SA),1949-1960,37,67,26,26,0,0,26,2 (2ct 0st),0.388,
30,Anil Dalpat (PAK),1984-1985,9,15,25,22,3,22,0,3 (3ct 0st),1.666,
31,Babar Azam (PAK),2016-2021,37,68,25,25,0,0,25,2 (2ct 0st),0.367,
32,BS Chandrasekhar (INDIA),1964-1979,58,102,25,25,0,0,25,2 (2ct 0st),0.245,
33,PG Fulton (NZ),2006-2014,23,42,25,25,0,0,25,3 (3ct 0st),0.595,
34,SE Gregory (AUS),1890-1912,58,107,25,25,0,0,25,2 (2ct 0st),0.233,
35,M Hendrick (ENG),1974-1981,30,56,25,25,0,0,25,3 (3ct 0st),0.446,
36,AH Jones (NZ),1987-1995,39,62,25,25,0,0,25,2 (2ct 0st),0.403,
37,CC Lewis (ENG),1990-1996,32,58,25,25,0,0,25,2 (2ct 0st),0.431,
38,MD Marshall (WI),1978-1991,81,153,25,25,0,0,25,2 (2ct 0st),0.163,
39,Mohammad Ashraful (BAN),2001-2013,61,91,25,25,0,0,25,2 (2ct 0st),0.274,
40,M Morkel (SA),2006-2018,86,160,25,25,0,0,25,2 (2ct 0st),0.156,
41,M Ntini (SA),1998-2009,101,192,25,25,0,0,25,1 (1ct 0st),0.13,
42,EC Petrie (NZ),1955-1966,14,18,25,25,0,25,0,4 (4ct 0st),1.388,
43,K Rabada (SA),2015-2022,50,93,25,25,0,0,25,2 (2ct 0st),0.268,
44,Shakib Al Hasan (BAN),2007-2021,59,102,25,25,0,0,25,2 (2ct 0st),0.245,
45,DL Amiss (ENG),1966-1977,50,90,24,24,0,0,24,2 (2ct 0st),0.266,
46,RJ Burns (ENG),2018-2022,32,62,24,24,0,0,24,2 (2ct 0st),0.387,
47,DB Close (ENG),1949-1976,22,44,24,24,0,0,24,3 (3ct 0st),0.545,
48,EJM Cowan (AUS),2011-2013,18,35,24,24,0,0,24,3 (3ct 0st),0.685,
49,PB Dassanayake (SL),1993-1994,11,14,24,19,5,19,0,5 (5ct 0st),1.714,
0,GC Dyer (AUS),1986-1988,6,11,24,22,2,22,0,4 (4ct 0st),2.181,
1,G Giffen (AUS),1881-1896,31,55,24,24,0,0,24,3 (3ct 0st),0.436,
2,HMRKB Herath (SL),1999-2018,93,172,24,24,0,0,24,2 (2ct 0st),0.139,
3,MJ Hoggard (ENG),2000-2008,67,125,24,24,0,0,24,2 (2ct 0st),0.192,
4,C Kelleway (AUS),1910-1928,26,47,24,24,0,0,24,3 (3ct 0st),0.51,
5,Mohammad Wasim (PAK),1996-2000,18,32,24,22,2,1,21,2 (2ct 0st),0.75,
6,OJ Pope (ENG),2018-2022,23,43,24,24,0,1,23,3 (3ct 0st),0.558,
7,VY Richardson (AUS),1924-1936,19,37,24,24,0,0,24,5 (5ct 0st),0.648,
8,RA Saggers (AUS),1948-1950,6,11,24,16,8,16,0,4 (1ct 3st),2.181,
9,SJ Snooke (SA),1906-1923,26,47,24,24,0,0,24,2 (2ct 0st),0.51,
10,WU Tharanga (SL),2005-2017,31,58,24,24,0,0,24,3 (3ct 0st),0.413,
11,CFK van Wyk (NZ),2012-2012,9,17,24,23,1,23,0,4 (4ct 0st),1.411,
12,T Bavuma (SA),2014-2022,47,86,23,23,0,0,23,2 (2ct 0st),0.267,
13,PJP Burge (AUS),1955-1966,42,78,23,23,0,0,23,2 (2ct 0st),0.294,
14,JA Burns (AUS),2014-2020,23,44,23,23,0,0,23,2 (2ct 0st),0.522,
15,AT Carey (AUS),2021-2022,5,10,23,23,0,23,0,5 (5ct 0st),2.3,
16,RG de Alwis (SL),1983-1988,11,14,23,21,2,21,0,4 (4ct 0st),1.642,
17,GT Dowling (NZ),1961-1972,39,71,23,23,0,0,23,3 (3ct 0st),0.323,
18,BF Hastings (NZ),1969-1976,31,54,23,23,0,0,23,3 (3ct 0st),0.425,
19,MG Hughes (AUS),1985-1994,53,97,23,23,0,0,23,2 (2ct 0st),0.237,
20,B Lee (AUS),1999-2008,76,151,23,23,0,0,23,2 (2ct 0st),0.152,
21,DK Lillee (AUS),1971-1984,70,133,23,23,0,0,23,2 (2ct 0st),0.172,
22,RA McLean (SA),1951-1964,40,72,23,23,0,0,23,2 (2ct 0st),0.319,
23,SE Marsh (AUS),2011-2019,38,72,23,23,0,0,23,2 (2ct 0st),0.319,
24,Mushtaq Ahmed (PAK),1990-2003,52,94,23,23,0,0,23,2 (2ct 0st),0.244,
25,SK Raina (INDIA),2010-2015,18,33,23,23,0,0,23,2 (2ct 0st),0.696,
26,I Sharma (INDIA),2007-2021,105,194,23,23,0,0,23,2 (2ct 0st),0.118,
27,Soumya Sarkar (BAN),2015-2021,16,27,23,23,0,0,23,4 (4ct 0st),0.851,
28,SB Styris (NZ),2002-2007,29,51,23,23,0,0,23,3 (3ct 0st),0.45,
29,H Sutcliffe (ENG),1924-1935,54,96,23,23,0,0,23,3 (3ct 0st),0.239,
30,GN Yallop (AUS),1976-1984,39,69,23,23,0,0,23,2 (2ct 0st),0.333,
31,Yasir Shah (PAK),2014-2021,46,86,23,23,0,0,23,2 (2ct 0st),0.267,
32,KLT Arthurton (WI),1988-1995,33,62,22,22,0,0,22,2 (2ct 0st),0.354,
33,Ashraf Ali (PAK),1982-1987,8,14,22,17,5,17,0,4 (2ct 2st),1.571,
34,GS Ballance (ENG),2014-2017,23,46,22,22,0,0,22,3 (3ct 0st),0.478,
35,IM Barrow (WI),1930-1939,11,16,22,17,5,16,1,3 (3ct 0st),1.375,
36,FR Brown (ENG),1931-1953,22,40,22,22,0,0,22,2 (2ct 0st),0.55,
37,Faisal Iqbal (PAK),2001-2010,26,46,22,22,0,0,22,3 (3ct 0st),0.478,
38,JDC Goddard (WI),1948-1957,27,51,22,22,0,0,22,2 (2ct 0st),0.431,
39,Habibul Bashar (BAN),2000-2008,50,70,22,22,0,0,22,2 (2ct 0st),0.314,
40,MA Holding (WI),1975-1987,60,114,22,22,0,0,22,2 (2ct 0st),0.192,
41,CD McMillan (NZ),1997-2005,55,99,22,22,0,0,22,1 (1ct 0st),0.222,
42,W Mathias (PAK),1955-1962,21,36,22,22,0,0,22,4 (4ct 0st),0.611,
43,RG Nadkarni (INDIA),1955-1968,41,73,22,22,0,0,22,2 (2ct 0st),0.301,
44,CM Old (ENG),1972-1981,46,84,22,22,0,0,22,2 (2ct 0st),0.261,
45,Shoaib Mohammad (PAK),1983-1995,45,79,22,22,0,0,22,2 (2ct 0st),0.278,
46,J Srinath (INDIA),1991-2002,67,122,22,22,0,0,22,2 (2ct 0st),0.18,
47,A Symonds (AUS),2004-2008,26,52,22,22,0,0,22,3 (3ct 0st),0.423,
48,AC Bannerman (AUS),1879-1893,28,49,21,21,0,0,21,2 (2ct 0st),0.428,
49,RW Barber (ENG),1960-1968,28,49,21,21,0,0,21,2 (2ct 0st),0.428,
0,TE Blain (NZ),1986-1994,11,17,21,19,2,18,1,4 (4ct 0st),1.235,
1,AR Caddick (ENG),1993-2003,62,106,21,21,0,0,21,2 (2ct 0st),0.198,
2,RJ Christiani (WI),1948-1954,22,44,21,19,2,1,18,3 (1ct 2st),0.477,
3,RM Cowper (AUS),1964-1968,27,50,21,21,0,0,21,2 (2ct 0st),0.42,
4,Z Crawley (ENG),2019-2022,18,33,21,21,0,0,21,4 (4ct 0st),0.636,
5,TM Findlay (WI),1969-1973,10,17,21,19,2,19,0,4 (4ct 0st),1.235,
6,JR Hazlewood (AUS),2014-2021,56,106,21,21,0,0,21,2 (2ct 0st),0.198,
7,GB Hole (AUS),1951-1955,18,35,21,21,0,0,21,4 (4ct 0st),0.6,
8,E Jones (AUS),1894-1902,19,34,21,21,0,0,21,3 (3ct 0st),0.617,
9,RAS Lakmal (SL),2010-2021,68,127,21,21,0,0,21,1 (1ct 0st),0.165,
10,RB McCosker (AUS),1975-1980,25,47,21,21,0,0,21,2 (2ct 0st),0.446,
11,VL Manjrekar (INDIA),1951-1965,55,96,21,19,2,2,17,2 (2ct 0st),0.218,
12,Mehidy Hasan Miraz (BAN),2016-2022,31,54,21,21,0,0,21,2 (2ct 0st),0.388,
13,BAG Murray (NZ),1968-1971,13,25,21,21,0,0,21,2 (2ct 0st),0.84,
14,SM Nurse (WI),1960-1969,29,54,21,21,0,1,20,2 (2ct 0st),0.388,
15,NCL O'Neill (AUS),1958-1965,42,82,21,21,0,0,21,2 (2ct 0st),0.256,
16,DG Phadkar (INDIA),1947-1959,31,50,21,21,0,0,21,2 (2ct 0st),0.42,
17,WH Ponsford (AUS),1924-1934,29,55,21,21,0,0,21,2 (2ct 0st),0.381,
18,JA Raval (NZ),2016-2020,24,46,21,21,0,0,21,3 (3ct 0st),0.456,
19,CJ Richards (ENG),1986-1988,8,15,21,20,1,20,0,5 (5ct 0st),1.4,
20,CM Spearman (NZ),1995-2000,19,38,21,21,0,0,21,2 (2ct 0st),0.552,
21,GHS Trott (AUS),1888-1898,24,44,21,21,0,0,21,2 (2ct 0st),0.477,
22,GOB Allen (ENG),1930-1948,25,47,20,20,0,0,20,2 (2ct 0st),0.425,
23,RG Archer (AUS),1953-1956,19,35,20,20,0,0,20,4 (4ct 0st),0.571,
24,D Bishoo (WI),2011-2018,36,64,20,20,0,0,20,3 (3ct 0st),0.312,
25,GA Faulkner (SA),1906-1924,25,44,20,20,0,0,20,3 (3ct 0st),0.454,
26,Intikhab Alam (PAK),1959-1977,47,87,20,20,0,0,20,2 (2ct 0st),0.229,
27,M Labuschagne (AUS),2018-2022,23,45,20,20,0,0,20,3 (3ct 0st),0.444,
28,LV Maddocks (AUS),1954-1956,7,11,20,19,1,19,0,4 (3ct 1st),1.818,
29,RS Morton (WI),2005-2008,15,26,20,20,0,0,20,2 (2ct 0st),0.769,
30,M Prabhakar (INDIA),1984-1995,39,69,20,20,0,0,20,2 (2ct 0st),0.289,
31,GS Ramchand (INDIA),1952-1960,33,57,20,20,0,0,20,3 (3ct 0st),0.35,
32,AC Smith (ENG),1962-1963,6,12,20,20,0,20,0,3 (3ct 0st),1.666,
33,EJ Smith (ENG),1911-1913,11,20,20,17,3,16,1,3 (3ct 0st),1.0,
34,JB Stollmeyer (WI),1939-1955,32,63,20,20,0,0,20,2 (2ct 0st),0.317,
35,B Sutcliffe (NZ),1947-1965,42,61,20,20,0,0,20,2 (2ct 0st),0.327,
36,CJ Tavare (ENG),1980-1989,31,56,20,20,0,0,20,1 (1ct 0st),0.357,
37,JR Thomson (AUS),1972-1985,51,94,20,20,0,0,20,1 (1ct 0st),0.212,
38,AEE Vogler (SA),1906-1911,15,28,20,20,0,0,20,4 (4ct 0st),0.714,
39,Wasim Raja (PAK),1973-1985,57,98,20,20,0,0,20,2 (2ct 0st),0.204,
40,Yasir Hameed (PAK),2003-2010,25,47,20,20,0,0,20,2 (2ct 0st),0.425,
41,Asif Mujtaba (PAK),1986-1997,25,44,19,19,0,0,19,2 (2ct 0st),0.431,
42,W Barnes (ENG),1880-1890,21,40,19,19,0,0,19,3 (3ct 0st),0.475,
43,MD Bell (NZ),1998-2008,18,33,19,19,0,0,19,2 (2ct 0st),0.575,
44,RL Chase (WI),2016-2021,43,75,19,19,0,0,19,3 (3ct 0st),0.253,
45,BT Foakes (ENG),2018-2021,8,15,19,14,5,14,0,3 (3ct 0st),1.266,
46,TW Hayward (ENG),1896-1909,35,67,19,19,0,0,19,2 (2ct 0st),0.283,
47,Z Khan (INDIA),2000-2014,92,173,19,19,0,0,19,2 (2ct 0st),0.109,
48,CJ McDermott (AUS),1984-1996,71,126,19,19,0,0,19,2 (2ct 0st),0.15,
49,R Mutumbami (ZIM),2013-2014,6,12,19,17,2,17,0,5 (4ct 1st),1.583,
0,MDK Perera (SL),2014-2021,43,79,19,19,0,0,19,2 (2ct 0st),0.24,
1,V Pollard (NZ),1965-1973,32,57,19,19,0,0,19,3 (3ct 0st),0.333,
2,Shahriar Nafees (BAN),2005-2013,24,38,19,19,0,0,19,2 (2ct 0st),0.5,
3,PM Siddle (AUS),2008-2019,67,128,19,19,0,0,19,2 (2ct 0st),0.148,
4,HW Taylor (SA),1912-1932,42,69,19,19,0,0,19,2 (2ct 0st),0.275,
5,G Ulyett (ENG),1877-1890,25,47,19,19,0,0,19,3 (3ct 0st),0.404,
6,HE van der Dussen (SA),2019-2022,13,25,19,19,0,0,19,3 (3ct 0st),0.76,
7,L Vincent (NZ),2001-2007,23,41,19,19,0,0,19,3 (3ct 0st),0.463,
8,GJ Whittall (ZIM),1993-2002,46,81,19,19,0,0,19,3 (3ct 0st),0.234,
9,TJ Zoehrer (AUS),1986-1987,10,16,19,18,1,18,0,3 (3ct 0st),1.187,
10,DW Allan (WI),1962-1966,5,10,18,15,3,15,0,3 (3ct 0st),1.8,
11,CEL Ambrose (WI),1988-2000,98,182,18,18,0,0,18,1 (1ct 0st),0.098,
12,N Boje (SA),2000-2006,43,80,18,18,0,0,18,2 (2ct 0st),0.225,
13,JW Burke (AUS),1951-1959,24,45,18,18,0,0,18,2 (2ct 0st),0.4,
14,NJ Contractor (INDIA),1955-1962,31,54,18,18,0,0,18,2 (2ct 0st),0.333,
15,DG Cork (ENG),1995-2002,37,65,18,18,0,0,18,2 (2ct 0st),0.276,
16,PJ Cummins (AUS),2011-2022,38,73,18,18,0,0,18,2 (2ct 0st),0.246,
17,Danish Kaneria (PAK),2000-2010,61,115,18,18,0,0,18,1 (1ct 0st),0.156,
18,AA Donald (SA),1992-2002,72,134,18,18,0,0,18,2 (2ct 0st),0.134,
19,JS Foster (ENG),2001-2002,7,13,18,17,1,17,0,5 (5ct 0st),1.384,
20,HA Gomes (WI),1976-1987,60,112,18,18,0,0,18,1 (1ct 0st),0.16,
21,GE Gomez (WI),1939-1954,29,58,18,18,0,0,18,3 (3ct 0st),0.31,
22,GH Hirst (ENG),1897-1909,24,44,18,18,0,0,18,2 (2ct 0st),0.409,
23,DAJ Holford (WI),1966-1977,24,42,18,18,0,0,18,2 (2ct 0st),0.428,
24,JM How (NZ),2006-2009,19,32,18,18,0,0,18,2 (2ct 0st),0.562,
25,AH Jarvis (AUS),1885-1895,11,19,18,9,9,8,1,3 (3ct 0st),0.947,
26,DJ McGlew (SA),1951-1962,34,63,18,18,0,0,18,3 (3ct 0st),0.285,
27,JA Maclean (AUS),1978-1979,4,8,18,18,0,18,0,5 (5ct 0st),2.25,
28,EAS Prasanna (INDIA),1962-1978,49,88,18,18,0,0,18,2 (2ct 0st),0.204,
29,S Ramesh (INDIA),1999-2001,19,36,18,18,0,0,18,2 (2ct 0st),0.5,
30,KAJ Roach (WI),2009-2021,68,123,18,18,0,0,18,2 (2ct 0st),0.146,
31,Saeed Anwar (PAK),1990-2001,55,101,18,18,0,0,18,2 (2ct 0st),0.178,
32,RO Schwarz (SA),1906-1912,20,36,18,18,0,0,18,2 (2ct 0st),0.5,
33,Shoaib Malik (PAK),2001-2015,35,67,18,18,0,0,18,2 (2ct 0st),0.268,
34,Taijul Islam (BAN),2014-2021,35,60,18,18,0,0,18,2 (2ct 0st),0.3,
35,Tamim Iqbal (BAN),2008-2021,64,110,18,18,0,0,18,2 (2ct 0st),0.163,
36,Waqar Younis (PAK),1989-2003,87,158,18,18,0,0,18,3 (3ct 0st),0.113,
37,GP Wickramasinghe (SL),1991-2001,40,65,18,18,0,0,18,2 (2ct 0st),0.276,
38,CR Woakes (ENG),2013-2022,42,80,18,18,0,0,18,2 (2ct 0st),0.225,
39,SFAF Bacchus (WI),1978-1982,19,34,17,17,0,0,17,3 (3ct 0st),0.5,
40,AP Binns (WI),1953-1956,5,10,17,14,3,14,0,3 (3ct 0st),1.7,
41,BC Booth (AUS),1961-1966,29,54,17,17,0,0,17,2 (2ct 0st),0.314,
42,DG Brownlie (NZ),2011-2013,14,25,17,17,0,0,17,4 (4ct 0st),0.68,
43,AN Connolly (AUS),1963-1971,29,55,17,17,0,0,17,2 (2ct 0st),0.309,
44,CB Fry (ENG),1896-1912,26,47,17,17,0,0,17,2 (2ct 0st),0.361,
45,JW Gleeson (AUS),1967-1972,29,56,17,17,0,0,17,2 (2ct 0st),0.303,
46,CV Grimmett (AUS),1925-1936,37,71,17,17,0,0,17,2 (2ct 0st),0.239,
47,JB Hobbs (ENG),1908-1930,61,110,17,17,0,0,17,2 (2ct 0st),0.154,
48,MJ Horne (NZ),1997-2003,35,65,17,17,0,0,17,3 (3ct 0st),0.261,
49,DL Houghton (ZIM),1992-1997,22,40,17,17,0,0,17,3 (3ct 0st),0.425,
0,ML Jaisimha (INDIA),1959-1971,39,72,17,17,0,0,17,1 (1ct 0st),0.236,
1,KK Jennings (ENG),2016-2019,17,32,17,17,0,0,17,4 (4ct 0st),0.531,
2,CG Macartney (AUS),1907-1926,35,64,17,17,0,0,17,1 (1ct 0st),0.265,
3,G MacGregor (ENG),1890-1893,8,15,17,14,3,14,0,3 (3ct 0st),1.133,
4,GRJ Matthews (AUS),1983-1993,33,56,17,17,0,0,17,2 (2ct 0st),0.303,
5,G Miller (ENG),1976-1984,34,62,17,17,0,0,17,2 (2ct 0st),0.274,
6,MJ North (AUS),2009-2010,21,40,17,17,0,0,17,2 (2ct 0st),0.425,
7,BP Patel (INDIA),1974-1977,21,37,17,17,0,0,17,3 (3ct 0st),0.459,
8,R Peel (ENG),1884-1896,20,38,17,17,0,0,17,2 (2ct 0st),0.447,
9,VD Philander (SA),2011-2020,64,119,17,17,0,0,17,1 (1ct 0st),0.142,
10,RG Pollock (SA),1963-1970,23,44,17,17,0,0,17,2 (2ct 0st),0.386,
11,LG Rowe (WI),1972-1980,30,55,17,17,0,0,17,2 (2ct 0st),0.309,
12,J Ryder (AUS),1920-1929,20,36,17,17,0,0,17,3 (3ct 0st),0.472,
13,PJ Sharpe (ENG),1963-1969,12,24,17,17,0,0,17,2 (2ct 0st),0.708,
14,AP Sheahan (AUS),1967-1974,31,60,17,17,0,0,17,1 (1ct 0st),0.283,
15,HH Streak (ZIM),1993-2005,65,110,17,17,0,0,17,2 (2ct 0st),0.154,
16,WW Wade (SA),1938-1950,11,18,17,15,2,15,0,3 (3ct 0st),0.944,
17,JT Ward (NZ),1964-1968,8,15,17,16,1,16,0,4 (4ct 0st),1.133,
18,AJ Watkins (ENG),1948-1952,15,26,17,17,0,0,17,3 (3ct 0st),0.653,
19,UT Yadav (INDIA),2011-2022,52,102,17,17,0,0,17,2 (2ct 0st),0.166,
20,Aamer Malik (PAK),1987-1994,14,26,16,15,1,4,11,4 (4ct 0st),0.615,
21,CT Bancroft (AUS),2017-2019,10,19,16,16,0,0,16,3 (3ct 0st),0.842,
22,AJ Bichel (AUS),1997-2003,19,38,16,16,0,0,16,2 (2ct 0st),0.421,
23,GJ Bonnor (AUS),1880-1888,17,29,16,16,0,0,16,3 (3ct 0st),0.551,
24,C de Grandhomme (NZ),2016-2021,26,51,16,16,0,0,16,2 (2ct 0st),0.313,
25,N Deonarine (WI),2005-2013,18,33,16,16,0,0,16,3 (3ct 0st),0.484,
26,M Dillon (WI),1997-2004,38,69,16,16,0,0,16,2 (2ct 0st),0.231,
27,SB Doull (NZ),1992-2000,32,53,16,16,0,0,16,2 (2ct 0st),0.301,
28,DD Ebrahim (ZIM),2001-2005,29,45,16,16,0,0,16,2 (2ct 0st),0.355,
29,CR Ervine (ZIM),2011-2020,18,31,16,16,0,0,16,4 (4ct 0st),0.516,
30,ST Gabriel (WI),2012-2021,56,99,16,16,0,0,16,2 (2ct 0st),0.161,
31,KD Ghavri (INDIA),1974-1981,39,69,16,16,0,0,16,2 (2ct 0st),0.231,
32,CC Griffith (WI),1960-1969,28,52,16,16,0,0,16,2 (2ct 0st),0.307,
33,SC Guillen (NZ/WI),1951-1956,8,15,16,13,3,13,0,3 (3ct 0st),1.066,
34,AJ Hall (SA),2002-2007,21,39,16,16,0,0,16,2 (2ct 0st),0.41,
35,Haroon Rasheed (PAK),1977-1983,23,41,16,16,0,0,16,2 (2ct 0st),0.39,
36,PL Harris (SA),2007-2011,37,69,16,16,0,0,16,2 (2ct 0st),0.231,
37,VA Holder (WI),1969-1979,40,74,16,16,0,0,16,1 (1ct 0st),0.216,
38,CC Hunte (WI),1958-1967,44,85,16,16,0,0,16,2 (2ct 0st),0.188,
39,Imran Butt (PAK),2021-2021,6,12,16,16,0,0,16,3 (3ct 0st),1.333,
40,FA Iredale (AUS),1894-1899,14,27,16,16,0,0,16,3 (3ct 0st),0.592,
41,KC James (NZ),1930-1933,11,16,16,11,5,11,0,2 (2ct 0st),1.0,
42,WR James (ZIM),1993-1994,4,7,16,16,0,16,0,5 (5ct 0st),2.285,
43,WA Johnston (AUS),1947-1955,40,79,16,16,0,0,16,2 (2ct 0st),0.202,
44,AH Kardar (INDIA/PAK),1946-1958,26,45,16,16,0,0,16,2 (2ct 0st),0.355,
45,MS Kasprowicz (AUS),1996-2006,38,75,16,16,0,0,16,2 (2ct 0st),0.213,
46,BM Laird (AUS),1979-1982,21,37,16,16,0,0,16,2 (2ct 0st),0.432,
47,SCG MacGill (AUS),1998-2008,44,87,16,16,0,0,16,2 (2ct 0st),0.183,
48,KD Mackay (AUS),1956-1963,37,71,16,16,0,0,16,2 (2ct 0st),0.225,
49,MR Marsh (AUS),2014-2019,32,62,16,16,0,0,16,2 (2ct 0st),0.258,
0,A Nel (SA),2001-2008,36,69,16,16,0,0,16,2 (2ct 0st),0.231,
1,CS Pandit (INDIA),1986-1992,5,9,16,14,2,11,3,4 (4ct 0st),1.777,
2,WW Read (ENG),1882-1893,18,35,16,16,0,0,16,2 (2ct 0st),0.457,
3,P Roy (INDIA),1951-1960,43,72,16,16,0,0,16,2 (2ct 0st),0.222,
4,MJ Santner (NZ),2015-2021,24,46,16,16,0,0,16,2 (2ct 0st),0.347,
5,Shan Masood (PAK),2013-2021,25,42,16,16,0,0,16,2 (2ct 0st),0.38,
6,V Sibanda (ZIM),2003-2014,14,27,16,16,0,0,16,3 (3ct 0st),0.592,
7,JA Snow (ENG),1965-1976,49,93,16,16,0,0,16,2 (2ct 0st),0.172,
8,JT Tyldesley (ENG),1899-1909,31,59,16,16,0,0,16,1 (1ct 0st),0.271,
9,K Verreynne (SA),2021-2022,4,8,16,16,0,14,2,5 (5ct 0st),2.0,
10,RES Wyatt (ENG),1927-1937,40,74,16,16,0,0,16,2 (2ct 0st),0.216,
11,Yashpal Sharma (INDIA),1979-1983,37,60,16,16,0,0,16,2 (2ct 0st),0.266,
12,Abdul Qadir (PAK),1977-1990,67,117,15,15,0,0,15,2 (2ct 0st),0.128,
13,Abdul Razzaq (PAK),1999-2006,46,85,15,15,0,0,15,2 (2ct 0st),0.176,
14,BF Butcher (WI),1958-1969,44,83,15,15,0,0,15,2 (2ct 0st),0.18,
15,AG Chipperfield (AUS),1934-1938,14,26,15,15,0,0,15,3 (3ct 0st),0.576,
16,A Chopra (INDIA),2003-2004,10,19,15,15,0,0,15,3 (3ct 0st),0.789,
17,RRS Cornwall (WI),2019-2021,9,17,15,15,0,0,15,3 (3ct 0st),0.882,
18,CI Dunusinghe (SL),1995-1995,5,9,15,13,2,13,0,4 (4ct 0st),1.666,
19,KA Edwards (WI),2011-2014,17,32,15,15,0,0,15,2 (2ct 0st),0.468,
20,AG Fairfax (AUS),1929-1931,10,19,15,15,0,0,15,3 (3ct 0st),0.789,
21,AD Gaekwad (INDIA),1974-1985,40,66,15,15,0,0,15,2 (2ct 0st),0.227,
22,G Gunn (ENG),1907-1930,15,30,15,15,0,0,15,2 (2ct 0st),0.5,
23,TM Head (AUS),2018-2022,23,45,15,15,0,0,15,2 (2ct 0st),0.333,
24,PJ Hughes (AUS),2009-2013,26,48,15,15,0,0,15,2 (2ct 0st),0.312,
25,AO Jones (ENG),1899-1909,12,23,15,15,0,0,15,2 (2ct 0st),0.652,
26,H Larwood (ENG),1926-1933,21,38,15,15,0,0,15,4 (4ct 0st),0.394,
27,S Madan Lal (INDIA),1974-1986,39,66,15,15,0,0,15,1 (1ct 0st),0.227,
28,PNF Mansell (SA),1951-1955,13,24,15,15,0,0,15,2 (2ct 0st),0.625,
29,G Millman (ENG),1961-1962,6,12,15,13,2,13,0,4 (2ct 2st),1.25,
30,AR Morris (AUS),1946-1955,46,90,15,15,0,0,15,2 (2ct 0st),0.166,
31,J Mubarak (SL),2002-2015,13,24,15,15,0,0,15,3 (3ct 0st),0.625,
32,WL Murdoch (AUS/ENG),1877-1892,19,36,15,14,1,3,11,3 (3ct 0st),0.416,
33,KJ O'Keeffe (AUS),1971-1977,24,47,15,15,0,0,15,2 (2ct 0st),0.319,
34,JDP Oram (NZ),2002-2009,33,60,15,15,0,0,15,2 (2ct 0st),0.25,
35,DN Patel (NZ),1987-1997,37,62,15,15,0,0,15,2 (2ct 0st),0.241,
36,PI Pocock (ENG),1968-1985,25,46,15,15,0,0,15,3 (3ct 0st),0.326,
37,MSK Prasad (INDIA),1999-2000,6,11,15,15,0,15,0,4 (4ct 0st),1.363,
38,Qasim Umar (PAK),1983-1986,26,42,15,15,0,0,15,2 (2ct 0st),0.357,
39,Rajin Saleh (BAN),2003-2008,24,37,15,15,0,1,14,3 (3ct 0st),0.405,
40,PR Reiffel (AUS),1992-1998,35,68,15,15,0,0,15,1 (1ct 0st),0.22,
41,CJL Rogers (AUS),2008-2015,25,49,15,15,0,0,15,3 (3ct 0st),0.306,
42,Saqlain Mushtaq (PAK),1995-2004,49,87,15,15,0,0,15,2 (2ct 0st),0.172,
43,PA Strang (ZIM),1994-2001,24,44,15,15,0,0,15,3 (3ct 0st),0.34,
44,DR Tuffey (NZ),2000-2010,26,46,15,15,0,0,15,2 (2ct 0st),0.326,
45,A Turner (AUS),1975-1977,14,27,15,15,0,0,15,4 (4ct 0st),0.555,
46,W Voce (ENG),1930-1947,27,51,15,15,0,0,15,2 (2ct 0st),0.294,
47,AC Voges (AUS),2015-2016,20,37,15,15,0,0,15,3 (3ct 0st),0.405,
48,CB Wishart (ZIM),1995-2005,27,45,15,15,0,0,15,2 (2ct 0st),0.333,
49,Azhar Mahmood (PAK),1997-2001,21,37,14,14,0,0,14,3 (3ct 0st),0.378,
0,RG Barlow (ENG),1881-1887,17,31,14,14,0,0,14,2 (2ct 0st),0.451,
1,SG Barnes (AUS),1938-1948,13,25,14,14,0,0,14,3 (3ct 0st),0.56,
2,CJ Barnett (ENG),1933-1948,20,39,14,14,0,0,14,2 (2ct 0st),0.358,
3,SJ Benn (WI),2008-2015,26,45,14,14,0,0,14,2 (2ct 0st),0.311,
4,SL Boock (NZ),1978-1989,30,54,14,14,0,0,14,2 (2ct 0st),0.259,
5,WA Brown (AUS),1934-1948,22,41,14,14,0,0,14,2 (2ct 0st),0.341,
6,CL Cairns (NZ),1989-2004,62,110,14,14,0,0,14,2 (2ct 0st),0.127,
7,GJ Cosier (AUS),1975-1978,18,34,14,14,0,0,14,2 (2ct 0st),0.411,
8,MD Craig (NZ),2014-2016,15,29,14,14,0,0,14,2 (2ct 0st),0.482,
9,PAJ DeFreitas (ENG),1986-1995,44,78,14,14,0,0,14,2 (2ct 0st),0.179,
10,HDPK Dharmasena (SL),1993-2004,31,53,14,14,0,0,14,3 (3ct 0st),0.264,
11,SS Dighe (INDIA),2001-2001,6,11,14,12,2,12,0,3 (3ct 0st),1.272,
12,RA Duff (AUS),1902-1905,22,41,14,14,0,0,14,2 (2ct 0st),0.341,
13,SA Durani (INDIA),1960-1973,29,53,14,14,0,0,14,3 (3ct 0st),0.264,
14,BA Edgar (NZ),1978-1986,39,72,14,14,0,3,11,3 (3ct 0st),0.194,
15,MTG Elliott (AUS),1996-2004,21,42,14,14,0,0,14,1 (1ct 0st),0.333,
16,PGH Fender (ENG),1921-1929,13,23,14,14,0,0,14,2 (2ct 0st),0.608,
17,TR Gripper (ZIM),1999-2004,20,32,14,14,0,0,14,2 (2ct 0st),0.437,
18,SP Gupte (INDIA),1951-1961,36,61,14,14,0,0,14,2 (2ct 0st),0.229,
19,Haris Sohail (PAK),2017-2021,16,28,14,14,0,0,14,2 (2ct 0st),0.5,
20,CZ Harris (NZ),1992-2002,23,38,14,14,0,0,14,3 (3ct 0st),0.368,
21,GA Headley (WI),1930-1954,22,38,14,14,0,0,14,2 (2ct 0st),0.368,
22,CJ Jordan (ENG),2014-2015,8,16,14,14,0,0,14,3 (3ct 0st),0.875,
23,BD Julien (WI),1973-1977,24,46,14,14,0,0,14,2 (2ct 0st),0.304,
24,M Kaif (INDIA),2000-2006,13,24,14,14,0,0,14,4 (4ct 0st),0.583,
25,BR Knight (ENG),1961-1969,29,55,14,14,0,0,14,2 (2ct 0st),0.254,
26,BW Luckhurst (ENG),1970-1974,21,39,14,14,0,0,14,2 (2ct 0st),0.358,
27,CL McCool (AUS),1946-1950,14,27,14,14,0,0,14,1 (1ct 0st),0.518,
28,CC McDonald (AUS),1952-1961,47,90,14,14,0,0,14,2 (2ct 0st),0.155,
29,AA Mailey (AUS),1920-1926,21,38,14,14,0,0,14,2 (2ct 0st),0.368,
30,CS Martin (NZ),2000-2013,71,128,14,14,0,0,14,1 (1ct 0st),0.109,
31,Mohammed Shami (INDIA),2013-2022,57,110,14,14,0,0,14,1 (1ct 0st),0.127,
32,DK Morrison (NZ),1987-1997,48,76,14,14,0,0,14,2 (2ct 0st),0.184,
33,R Pilling (ENG),1881-1888,8,14,14,10,4,10,0,3 (1ct 2st),1.0,
34,AE Relf (ENG),1903-1914,13,25,14,14,0,0,14,2 (2ct 0st),0.56,
35,GM Ritchie (AUS),1982-1987,30,48,14,14,0,0,14,2 (2ct 0st),0.291,
36,EAB Rowan (SA),1935-1951,26,43,14,14,0,0,14,2 (2ct 0st),0.325,
37,CB van Ryneveld (SA),1951-1958,19,35,14,14,0,0,14,2 (2ct 0st),0.4,
38,N Wagner (NZ),2012-2022,56,107,14,14,0,0,14,1 (1ct 0st),0.13,
39,SM Warnapura (SL),2007-2009,14,26,14,14,0,0,14,2 (2ct 0st),0.538,
40,C White (ENG),1994-2002,30,53,14,14,0,0,14,3 (3ct 0st),0.264,
41,NWD Yardley (ENG),1938-1950,20,36,14,14,0,0,14,2 (2ct 0st),0.388,
42,R Abel (ENG),1888-1902,13,26,13,13,0,0,13,3 (3ct 0st),0.5,
43,MA Agarwal (INDIA),2018-2022,19,38,13,13,0,0,13,2 (2ct 0st),0.342,
44,L Amarnath (INDIA),1933-1952,24,38,13,13,0,5,8,3 (3ct 0st),0.342,
45,J Arun Lal (INDIA),1982-1989,16,30,13,13,0,0,13,2 (2ct 0st),0.433,
46,CWJ Athey (ENG),1980-1988,23,38,13,13,0,0,13,2 (2ct 0st),0.342,
47,DL Bairstow (ENG),1979-1981,4,7,13,12,1,12,0,4 (4ct 0st),1.857,
48,AB Barath (WI),2009-2012,15,27,13,13,0,0,13,3 (3ct 0st),0.481,
49,AM Blignaut (ZIM),2001-2005,19,31,13,13,0,0,13,3 (3ct 0st),0.419,
0,RJ Bright (AUS),1977-1986,25,42,13,13,0,0,13,1 (1ct 0st),0.309,
1,HD Bromfield (SA),1961-1965,9,18,13,13,0,0,13,2 (2ct 0st),0.722,
2,MC Carew (WI),1963-1972,19,35,13,13,0,0,13,3 (3ct 0st),0.371,
3,JE Cheetham (SA),1949-1955,24,43,13,13,0,0,13,3 (3ct 0st),0.302,
4,HL Collins (AUS),1920-1926,19,35,13,13,0,0,13,2 (2ct 0st),0.371,
5,JN Crawford (ENG),1906-1908,12,23,13,13,0,0,13,3 (3ct 0st),0.565,
6,D Dasgupta (INDIA),2001-2002,8,15,13,13,0,13,0,3 (3ct 0st),0.866,
7,JHW Fingleton (AUS),1932-1938,18,33,13,13,0,0,13,2 (2ct 0st),0.393,
8,RE Foster (ENG),1903-1907,8,16,13,13,0,0,13,2 (2ct 0st),0.812,
9,G Geary (ENG),1924-1934,14,24,13,13,0,0,13,2 (2ct 0st),0.541,
10,HM Goonatilleke (SL),1982-1982,5,9,13,10,3,10,0,4 (3ct 1st),1.444,
11,D Gough (ENG),1994-2003,58,99,13,13,0,0,13,2 (2ct 0st),0.131,
12,RS Grant (WI),1935-1939,7,14,13,13,0,0,13,3 (3ct 0st),0.928,
13,RJ Harris (AUS),2010-2015,27,52,13,13,0,0,13,2 (2ct 0st),0.25,
14,JW Hearne (ENG),1911-1926,24,42,13,13,0,0,13,2 (2ct 0st),0.309,
15,AMJ Hilditch (AUS),1979-1985,18,28,13,13,0,0,13,2 (2ct 0st),0.464,
16,AF Kippax (AUS),1925-1934,22,43,13,13,0,0,13,1 (1ct 0st),0.302,
17,M Leyland (ENG),1928-1938,41,75,13,13,0,0,13,2 (2ct 0st),0.173,
18,AR MacGibbon (NZ),1951-1958,26,38,13,13,0,0,13,2 (2ct 0st),0.342,
19,DJ Malan (ENG),2017-2022,22,40,13,13,0,0,13,2 (2ct 0st),0.325,
20,Maqsood Ahmed (PAK),1952-1955,16,27,13,13,0,0,13,2 (2ct 0st),0.481,
21,DPB Morkel (SA),1927-1932,16,28,13,13,0,0,13,2 (2ct 0st),0.464,
22,DJ Nash (NZ),1992-2001,32,56,13,13,0,0,13,2 (2ct 0st),0.232,
23,GE Palmer (AUS),1880-1886,17,30,13,13,0,0,13,2 (2ct 0st),0.433,
24,JS Patel (NZ),2006-2017,24,43,13,13,0,0,13,3 (3ct 0st),0.302,
25,KS Ranjitsinhji (ENG),1896-1902,15,26,13,13,0,0,13,2 (2ct 0st),0.5,
26,A Ratra (INDIA),2002-2002,6,11,13,11,2,11,0,3 (2ct 1st),1.181,
27,GJ Rennie (ZIM),1997-2002,23,37,13,13,0,0,13,1 (1ct 0st),0.351,
28,Saeed Ahmed (PAK),1958-1973,41,70,13,13,0,0,13,2 (2ct 0st),0.185,
29,CS Serjeant (AUS),1977-1978,12,22,13,13,0,0,13,3 (3ct 0st),0.59,
30,JS Solomon (WI),1958-1965,27,53,13,13,0,0,13,2 (2ct 0st),0.245,
31,AL Valentine (WI),1950-1962,36,70,13,13,0,0,13,1 (1ct 0st),0.185,
32,DJ Vilas (SA),2015-2016,6,10,13,13,0,13,0,4 (4ct 0st),1.3,
33,DF Whatmore (AUS),1979-1979,7,11,13,13,0,0,13,4 (4ct 0st),1.181,
34,SC Williams (ZIM),2013-2021,14,26,13,13,0,0,13,2 (2ct 0st),0.5,
35,J Worrall (AUS),1885-1899,11,19,13,13,0,0,13,3 (3ct 0st),0.684,
36,TJE Andrews (AUS),1921-1926,16,28,12,12,0,0,12,2 (2ct 0st),0.428,
37,W Bardsley (AUS),1909-1926,41,74,12,12,0,0,12,1 (1ct 0st),0.162,
38,SF Barnes (ENG),1901-1914,27,52,12,12,0,0,12,2 (2ct 0st),0.23,
39,WKM Benjamin (WI),1987-1995,21,38,12,12,0,0,12,2 (2ct 0st),0.315,
40,J Briggs (ENG),1884-1899,33,63,12,12,0,0,12,2 (2ct 0st),0.19,
41,G Brown (ENG),1921-1923,7,12,12,9,3,9,0,3 (1ct 2st),1.0,
42,W Bruce (AUS),1885-1895,14,24,12,12,0,0,12,3 (3ct 0st),0.5,
43,RH Catterall (SA),1922-1931,24,41,12,12,0,0,12,3 (3ct 0st),0.292,
44,RK Chauhan (INDIA),1993-1998,21,36,12,12,0,0,12,2 (2ct 0st),0.333,
45,AG Cremer (ZIM),2005-2017,19,29,12,12,0,0,12,2 (2ct 0st),0.413,
46,MH Dekker (ZIM),1993-1996,14,25,12,12,0,0,12,4 (4ct 0st),0.48,
47,BOP Fernando (SL),2019-2021,13,25,12,12,0,0,12,2 (2ct 0st),0.48,
48,JEC Franklin (NZ),2001-2013,31,56,12,12,0,0,12,1 (1ct 0st),0.214,
49,GM Fullerton (SA),1947-1951,7,13,12,10,2,6,4,4 (3ct 1st),0.923,
0,EA Halliwell (SA),1892-1902,8,13,12,10,2,10,0,2 (2ct 0st),0.923,
1,DW Hookes (AUS),1977-1985,23,42,12,12,0,0,12,2 (2ct 0st),0.285,
2,WP Howell (AUS),1898-1904,18,33,12,12,0,0,12,2 (2ct 0st),0.363,
3,NC Johnson (ZIM),1998-2000,13,21,12,12,0,0,12,3 (3ct 0st),0.571,
4,SP Jones (AUS),1882-1888,12,21,12,12,0,0,12,2 (2ct 0st),0.571,
5,JC Laker (ENG),1948-1959,46,91,12,12,0,0,12,1 (1ct 0st),0.131,
6,KA Maharaj (SA),2016-2022,39,74,12,12,0,0,12,1 (1ct 0st),0.162,
7,AV Mankad (INDIA),1969-1978,22,43,12,12,0,0,12,2 (2ct 0st),0.279,
8,RW Morgan (NZ),1965-1972,20,37,12,12,0,0,12,2 (2ct 0st),0.324,
9,JDS Neesham (NZ),2014-2017,12,24,12,12,0,0,12,3 (3ct 0st),0.5,
10,AD Nourse (SA),1935-1951,34,57,12,12,0,0,12,2 (2ct 0st),0.21,
11,SM Patil (INDIA),1980-1984,29,49,12,12,0,0,12,2 (2ct 0st),0.244,
12,V Rathour (INDIA),1996-1997,6,11,12,12,0,0,12,2 (2ct 0st),1.09,
13,RWV Robins (ENG),1929-1937,19,38,12,12,0,0,12,3 (3ct 0st),0.315,
14,JD Ryder (NZ),2008-2011,18,32,12,12,0,0,12,2 (2ct 0st),0.375,
15,Salman Butt (PAK),2003-2010,33,63,12,12,0,0,12,2 (2ct 0st),0.19,
16,Rev.DS Sheppard (ENG),1950-1963,22,42,12,12,0,0,12,1 (1ct 0st),0.285,
17,Shoaib Akhtar (PAK),1997-2007,46,86,12,12,0,0,12,2 (2ct 0st),0.139,
18,DP Sibley (ENG),2019-2021,22,41,12,12,0,0,12,2 (2ct 0st),0.292,
19,RT Spooner (ENG),1951-1955,7,12,12,10,2,10,0,3 (2ct 1st),1.0,
20,PCR Tufnell (ENG),1990-2001,42,74,12,12,0,0,12,1 (1ct 0st),0.162,
21,Umar Akmal (PAK),2009-2011,16,31,12,12,0,0,12,2 (2ct 0st),0.387,
22,MRJ Veletta (AUS),1987-1990,8,14,12,12,0,0,12,2 (2ct 0st),0.857,
23,MHN Walker (AUS),1972-1977,34,64,12,12,0,0,12,1 (1ct 0st),0.187,
24,JH Wardle (ENG),1948-1957,28,56,12,12,0,0,12,3 (3ct 0st),0.214,
25,C Washbrook (ENG),1937-1956,37,69,12,12,0,0,12,2 (2ct 0st),0.173,
26,JC Watkins (SA),1949-1957,15,28,12,12,0,0,12,3 (3ct 0st),0.428,
27,BW Yuile (NZ),1963-1969,17,29,12,12,0,0,12,2 (2ct 0st),0.413,
28,DS Atkinson (WI),1948-1958,22,43,11,11,0,0,11,2 (2ct 0st),0.255,
29,AM Bacher (SA),1996-1999,19,35,11,11,0,0,11,2 (2ct 0st),0.314,
30,RMH Binny (INDIA),1979-1987,27,47,11,11,0,0,11,1 (1ct 0st),0.234,
31,JH Board (ENG),1899-1906,6,11,11,8,3,8,0,2 (2ct 0st),1.0,
32,TB de Bruyn (SA),2017-2019,12,21,11,11,0,0,11,4 (4ct 0st),0.523,
33,CC Depeiaza (WI),1955-1956,5,9,11,7,4,6,1,3 (1ct 2st),1.222,
34,PS de Villiers (SA),1993-1998,18,35,11,11,0,0,11,2 (2ct 0st),0.314,
35,Harry Elliott (ENG),1928-1934,4,8,11,8,3,8,0,3 (3ct 0st),1.375,
36,Fawad Alam (PAK),2009-2021,15,27,11,11,0,0,11,2 (2ct 0st),0.407,
37,Fazal Mahmood (PAK),1952-1962,34,56,11,11,0,0,11,1 (1ct 0st),0.196,
38,W Ferguson (WI),1948-1954,8,16,11,11,0,0,11,3 (3ct 0st),0.687,
39,FR Foster (ENG),1911-1912,11,20,11,11,0,0,11,2 (2ct 0st),0.55,
40,Ghulam Ahmed (INDIA),1948-1959,22,37,11,11,0,0,11,1 (1ct 0st),0.297,
41,WW Hall (WI),1958-1969,48,92,11,11,0,0,11,1 (1ct 0st),0.119,
42,Hanumant Singh (INDIA),1964-1969,14,25,11,11,0,0,11,2 (2ct 0st),0.44,
43,RI Harford (NZ),1968-1968,3,6,11,11,0,11,0,5 (5ct 0st),1.833,
44,VS Hazare (INDIA),1946-1953,30,48,11,11,0,0,11,2 (2ct 0st),0.229,
45,AJY Hopkins (AUS),1902-1909,20,38,11,11,0,0,11,2 (2ct 0st),0.289,
46,J Hunter (ENG),1884-1885,5,10,11,8,3,8,0,4 (2ct 2st),1.1,
47,GL Jessop (ENG),1899-1912,18,34,11,11,0,0,11,2 (2ct 0st),0.323,
48,Junaid Siddique (BAN),2008-2012,19,33,11,11,0,0,11,2 (2ct 0st),0.333,
49,RWT Key (ENG),2002-2005,15,27,11,11,0,0,11,2 (2ct 0st),0.407,
0,DS Lehmann (AUS),1998-2004,27,54,11,11,0,0,11,1 (1ct 0st),0.203,
1,JK Lever (ENG),1976-1986,21,38,11,11,0,0,11,1 (1ct 0st),0.289,
2,P Lever (ENG),1970-1975,17,31,11,11,0,0,11,2 (2ct 0st),0.354,
3,D Lloyd (ENG),1974-1975,9,18,11,11,0,0,11,3 (3ct 0st),0.611,
4,EJG Morgan (ENG),2010-2012,16,32,11,11,0,0,11,2 (2ct 0st),0.343,
5,PWA Mulder (SA),2019-2021,7,14,11,11,0,0,11,3 (3ct 0st),0.785,
6,BA Murphy (ZIM),2000-2001,11,20,11,11,0,0,11,1 (1ct 0st),0.55,
7,Nasim-ul-Ghani (PAK),1958-1973,29,49,11,11,0,0,11,2 (2ct 0st),0.224,
8,Najmul Hossain Shanto (BAN),2017-2022,13,22,11,11,0,0,11,2 (2ct 0st),0.5,
9,MS Nichols (ENG),1930-1939,14,24,11,11,0,0,11,2 (2ct 0st),0.458,
10,MHW Papps (NZ),2004-2007,8,14,11,11,0,0,11,2 (2ct 0st),0.785,
11,KD Petersen (SA),2021-2022,5,10,11,11,0,0,11,3 (3ct 0st),1.1,
12,H Philipson (ENG),1892-1895,5,9,11,8,3,8,0,3 (1ct 2st),1.222,
13,B Reddy (INDIA),1979-1979,4,5,11,9,2,9,0,3 (3ct 0st),2.2,
14,Rubel Hossain (BAN),2009-2020,27,47,11,11,0,0,11,1 (1ct 0st),0.234,
15,HD Rutherford (NZ),2013-2015,16,31,11,11,0,0,11,3 (3ct 0st),0.354,
16,Saeed Ajmal (PAK),2009-2014,35,67,11,11,0,0,11,2 (2ct 0st),0.164,
17,Saleem Elahi (PAK),1995-2003,13,23,11,10,1,0,10,4 (4ct 0st),0.478,
18,Shadab Kabir (PAK),1996-2002,5,9,11,11,0,0,11,3 (3ct 0st),1.222,
19,IS Sodhi (NZ),2013-2018,17,33,11,11,0,0,11,2 (2ct 0st),0.333,
20,FR Spofforth (AUS),1877-1887,18,31,11,11,0,0,11,3 (3ct 0st),0.354,
21,W Storer (ENG),1897-1899,6,10,11,11,0,11,0,3 (3ct 0st),1.1,
22,BC Strang (ZIM),1995-2001,26,46,11,11,0,0,11,1 (1ct 0st),0.239,
23,MW Tate (ENG),1924-1935,39,68,11,11,0,0,11,2 (2ct 0st),0.161,
24,JM Taylor (AUS),1920-1926,20,37,11,11,0,0,11,1 (1ct 0st),0.297,
25,Umar Gul (PAK),2003-2013,47,91,11,11,0,0,11,2 (2ct 0st),0.12,
26,PL van der Merwe (SA),1963-1967,15,30,11,11,0,0,11,2 (2ct 0st),0.366,
27,M van Jaarsveld (SA),2002-2004,9,17,11,11,0,0,11,2 (2ct 0st),0.647,
28,S Viswanath (INDIA),1985-1985,3,6,11,11,0,11,0,4 (4ct 0st),1.833,
29,TW Wall (AUS),1929-1934,18,34,11,11,0,0,11,2 (2ct 0st),0.323,
30,PJ Wiseman (NZ),1998-2005,25,48,11,11,0,0,11,2 (2ct 0st),0.229,
31,A Wood (ENG),1938-1939,4,7,11,10,1,10,0,2 (2ct 0st),1.571,
32,Yajurvindra Singh (INDIA),1977-1979,4,8,11,11,0,0,11,5 (5ct 0st),1.375,
33,Afsar Zazai (AFG),2018-2021,5,9,10,9,1,9,0,2 (2ct 0st),1.111,
34,DA Allen (ENG),1960-1966,39,69,10,10,0,0,10,2 (2ct 0st),0.144,
35,Al Sahariar (BAN),2000-2003,15,20,10,10,0,0,10,3 (3ct 0st),0.5,
36,Asim Kamal (PAK),2003-2005,12,23,10,10,0,0,10,2 (2ct 0st),0.434,
37,A Bacher (SA),1965-1970,12,24,10,10,0,0,10,2 (2ct 0st),0.416,
38,GJ Bailey (AUS),2013-2014,5,10,10,10,0,0,10,2 (2ct 0st),1.0,
39,KC Bland (SA),1961-1966,21,40,10,10,0,0,10,2 (2ct 0st),0.25,
40,HF Boyle (AUS),1879-1884,12,23,10,10,0,0,10,1 (1ct 0st),0.434,
41,DAJ Bracewell (NZ),2011-2016,27,49,10,10,0,0,10,2 (2ct 0st),0.204,
42,BC Broad (ENG),1984-1989,25,41,10,10,0,0,10,2 (2ct 0st),0.243,
43,ME Chapple (NZ),1953-1966,14,26,10,10,0,0,10,2 (2ct 0st),0.384,
44,RO Collinge (NZ),1965-1978,35,63,10,10,0,0,10,1 (1ct 0st),0.158,
45,RDB Croft (ENG),1996-2001,21,35,10,10,0,0,10,2 (2ct 0st),0.285,
46,WW Davis (WI),1983-1988,15,28,10,10,0,0,10,2 (2ct 0st),0.357,
47,OC Dawson (SA),1947-1949,9,17,10,10,0,0,10,3 (3ct 0st),0.588,
48,GR Dilley (ENG),1979-1989,41,66,10,10,0,0,10,2 (2ct 0st),0.151,
49,DR Doshi (INDIA),1979-1983,33,57,10,10,0,0,10,2 (2ct 0st),0.175,
0,KS Duleepsinhji (ENG),1929-1931,12,17,10,10,0,0,10,2 (2ct 0st),0.588,
1,J Dyson (AUS),1977-1984,30,56,10,10,0,0,10,2 (2ct 0st),0.178,
2,FH Edwards (WI),2003-2012,55,102,10,10,0,0,10,1 (1ct 0st),0.098,
3,CRD Fernando (SL),2000-2012,40,69,10,10,0,0,10,2 (2ct 0st),0.144,
4,DR Flynn (NZ),2008-2013,24,40,10,10,0,0,10,2 (2ct 0st),0.25,
5,G Fowler (ENG),1982-1985,21,39,10,10,0,0,10,1 (1ct 0st),0.256,
6,MW Goodwin (ZIM),1998-2000,19,32,10,10,0,0,10,3 (3ct 0st),0.312,
7,GC Grant (WI),1930-1935,12,18,10,10,0,0,10,2 (2ct 0st),0.555,
8,RE Grieveson (SA),1939-1939,2,4,10,7,3,7,0,3 (3ct 0st),2.5,
9,HSTL Hendry (AUS),1921-1929,11,22,10,10,0,0,10,3 (3ct 0st),0.454,
10,Hon.FS Jackson (ENG),1893-1905,20,36,10,10,0,0,10,2 (2ct 0st),0.277,
11,Javed Omar (BAN),2001-2007,40,54,10,10,0,0,10,2 (2ct 0st),0.185,
12,DRE Joseph (WI),1999-1999,4,8,10,10,0,0,10,3 (3ct 0st),1.25,
13,RS Kalpage (SL),1993-1999,11,16,10,10,0,0,10,2 (2ct 0st),0.625,
14,GF Lawson (AUS),1980-1989,46,81,10,10,0,0,10,2 (2ct 0st),0.123,
15,PA McAlister (AUS),1904-1909,8,16,10,10,0,0,10,2 (2ct 0st),0.625,
16,TG McIntosh (NZ),2008-2011,17,32,10,10,0,0,10,2 (2ct 0st),0.312,
17,CA McWatt (WI),1954-1955,6,11,10,9,1,9,0,3 (3ct 0st),0.909,
18,IL Mendonca (WI),1962-1962,2,4,10,8,2,8,0,3 (2ct 1st),2.5,
19,WE Midwinter (AUS/ENG),1877-1887,12,22,10,10,0,0,10,2 (2ct 0st),0.454,
20,PJ Moor (ZIM),2016-2018,8,14,10,9,1,6,3,3 (2ct 1st),0.714,
21,MD Moxon (ENG),1986-1989,10,16,10,10,0,0,10,3 (3ct 0st),0.625,
22,Nasir Hossain (BAN),2011-2017,19,33,10,10,0,0,10,2 (2ct 0st),0.303,
23,Nurul Hasan (BAN),2017-2022,5,8,10,7,3,7,0,3 (0ct 3st),1.25,
24,PP Ojha (INDIA),2009-2013,24,48,10,10,0,0,10,1 (1ct 0st),0.208,
25,HK Olonga (ZIM),1995-2002,30,51,10,10,0,0,10,2 (2ct 0st),0.196,
26,MS Panesar (ENG),2006-2013,50,90,10,10,0,0,10,1 (1ct 0st),0.111,
27,DR Pringle (ENG),1982-1992,30,56,10,10,0,0,10,2 (2ct 0st),0.178,
28,KR Pushpakumara (SL),1994-2001,23,39,10,10,0,0,10,3 (3ct 0st),0.256,
29,AF Rae (WI),1948-1953,15,30,10,10,0,0,10,2 (2ct 0st),0.333,
30,VS Ransford (AUS),1907-1912,20,39,10,10,0,0,10,2 (2ct 0st),0.256,
31,Shahid Afridi (PAK),1998-2010,27,52,10,10,0,0,10,2 (2ct 0st),0.192,
32,BR Taylor (NZ),1965-1973,30,55,10,10,0,0,10,1 (1ct 0st),0.181,
33,PL Taylor (AUS),1987-1991,13,23,10,10,0,0,10,2 (2ct 0st),0.434,
34,EFS Tylecote (ENG),1882-1886,6,12,10,5,5,5,0,3 (1ct 2st),0.833,
35,KDK Vithanage (SL),2013-2015,10,20,10,10,0,0,10,2 (2ct 0st),0.5,
36,MN Waller (ZIM),2011-2017,14,25,10,10,0,0,10,2 (2ct 0st),0.4,
37,CAK Walton (WI),2009-2009,2,4,10,10,0,10,0,5 (5ct 0st),2.5,
38,Waqar Hasan (PAK),1952-1959,21,36,10,10,0,0,10,2 (2ct 0st),0.277,
39,S Wettimuny (SL),1982-1987,23,35,10,10,0,0,10,2 (2ct 0st),0.285,
40,GC White (SA),1906-1912,17,31,10,10,0,0,10,2 (2ct 0st),0.322,
41,AGD Wickremasinghe (SL),1989-1992,3,6,10,9,1,9,0,3 (3ct 0st),1.666,
42,RA Woolmer (ENG),1975-1981,19,36,10,10,0,0,10,2 (2ct 0st),0.277,
43,DVP Wright (ENG),1938-1951,34,62,10,10,0,0,10,2 (2ct 0st),0.161,
44,NS Yadav (INDIA),1979-1987,35,64,10,10,0,0,10,1 (1ct 0st),0.156,
45,Zulqarnain (PAK),1986-1986,3,6,10,8,2,8,0,3 (3ct 0st),1.666,
46,PK Amre (INDIA),1992-1993,11,21,9,9,0,0,9,2 (2ct 0st),0.428,
47,GG Arnold (ENG),1967-1975,34,61,9,9,0,0,9,2 (2ct 0st),0.147,
48,W Attewell (ENG),1884-1892,10,20,9,9,0,0,9,2 (2ct 0st),0.45,
49,W Bates (ENG),1881-1887,15,29,9,9,0,0,9,1 (1ct 0st),0.31,
0,JM Blanckenberg (SA),1913-1924,18,29,9,9,0,0,9,2 (2ct 0st),0.31,
1,NE Bonner (WI),2021-2021,9,17,9,9,0,0,9,2 (2ct 0st),0.529,
2,BJT Bosanquet (ENG),1903-1905,7,13,9,9,0,0,9,2 (2ct 0st),0.692,
3,G Cook (ENG),1982-1983,7,13,9,9,0,0,9,2 (2ct 0st),0.692,
4,NG Cowans (ENG),1982-1985,19,36,9,9,0,0,9,1 (1ct 0st),0.25,
5,IC Davis (AUS),1973-1977,15,28,9,9,0,0,9,2 (2ct 0st),0.321,
6,ALF de Mel (SL),1982-1986,17,27,9,9,0,0,9,2 (2ct 0st),0.333,
7,RB Desai (INDIA),1959-1968,28,45,9,9,0,0,9,2 (2ct 0st),0.2,
8,JWHT Douglas (ENG),1911-1925,23,42,9,9,0,0,9,3 (3ct 0st),0.214,
9,T Emmett (ENG),1877-1882,7,13,9,9,0,0,9,3 (3ct 0st),0.692,
10,LE Favell (AUS),1954-1961,19,37,9,9,0,0,9,2 (2ct 0st),0.243,
11,DW Fleming (AUS),1994-2001,20,38,9,9,0,0,9,2 (2ct 0st),0.236,
12,ARC Fraser (ENG),1989-1998,46,80,9,9,0,0,9,2 (2ct 0st),0.112,
13,C Green (AUS),2020-2022,9,18,9,9,0,0,9,2 (2ct 0st),0.5,
14,JH Hampshire (ENG),1969-1975,8,16,9,9,0,0,9,2 (2ct 0st),0.562,
15,J Hardstaff jnr (ENG),1935-1948,23,44,9,9,0,0,9,1 (1ct 0st),0.204,
16,MN Hart (NZ),1994-1995,14,22,9,9,0,0,9,1 (1ct 0st),0.409,
17,NJN Hawke (AUS),1963-1968,27,50,9,9,0,0,9,1 (1ct 0st),0.18,
18,BJ Hodge (AUS),2005-2008,6,12,9,9,0,0,9,2 (2ct 0st),0.75,
19,RIC Holder (WI),1997-1999,11,19,9,9,0,0,9,2 (2ct 0st),0.473,
20,GJ Hopkins (NZ),2008-2010,4,6,9,9,0,9,0,3 (3ct 0st),1.5,
21,KL Hutchings (ENG),1907-1909,7,14,9,9,0,0,9,2 (2ct 0st),0.642,
22,RA Hutton (ENG),1971-1971,5,9,9,9,0,0,9,2 (2ct 0st),1.0,
23,KS Indrajitsinhji (INDIA),1964-1969,4,8,9,6,3,6,0,2 (2ct 0st),1.125,
24,HJ Keith (SA),1953-1957,8,16,9,9,0,0,9,2 (2ct 0st),0.562,
25,LF Kline (AUS),1957-1961,13,25,9,9,0,0,9,2 (2ct 0st),0.36,
26,MJ Leach (ENG),2018-2022,19,35,9,9,0,0,9,2 (2ct 0st),0.257,
27,RA Legall (WI),1953-1953,4,8,9,8,1,8,0,3 (3ct 0st),1.125,
28,SN McGregor (NZ),1955-1965,25,39,9,9,0,0,9,1 (1ct 0st),0.23,
29,CE McLeod (AUS),1894-1905,17,31,9,9,0,0,9,1 (1ct 0st),0.29,
30,RS Madugalle (SL),1982-1988,21,34,9,9,0,0,9,2 (2ct 0st),0.264,
31,Maninder Singh (INDIA),1982-1993,35,57,9,9,0,0,9,1 (1ct 0st),0.157,
32,Mansoor Akhtar (PAK),1980-1990,19,34,9,9,0,0,9,1 (1ct 0st),0.264,
33,MK Mantri (INDIA),1951-1955,4,8,9,8,1,6,2,4 (3ct 1st),1.125,
34,Mashrafe Mortaza (BAN),2001-2009,36,52,9,9,0,0,9,1 (1ct 0st),0.173,
35,I Meckiff (AUS),1957-1963,18,36,9,9,0,0,9,2 (2ct 0st),0.25,
36,LRD Mendis (SL),1982-1988,24,37,9,9,0,0,9,1 (1ct 0st),0.243,
37,A Mitchell (ENG),1933-1936,6,12,9,9,0,0,9,2 (2ct 0st),0.75,
38,TM Moody (AUS),1989-1992,8,13,9,9,0,0,9,2 (2ct 0st),0.692,
39,JFM Morrison (NZ),1973-1982,17,29,9,9,0,0,9,2 (2ct 0st),0.31,
40,RC Motz (NZ),1961-1969,32,58,9,9,0,0,9,1 (1ct 0st),0.155,
41,Naushad Ali (PAK),1965-1965,6,11,9,9,0,9,0,3 (3ct 0st),0.818,
42,EP Nupen (SA),1921-1936,17,32,9,9,0,0,9,2 (2ct 0st),0.281,
43,Pervez Sajjad (PAK),1964-1973,19,37,9,9,0,0,9,1 (1ct 0st),0.243,
44,RJ Peterson (SA),2003-2014,15,29,9,9,0,0,9,2 (2ct 0st),0.31,
45,PM Pollock (SA),1961-1970,28,54,9,9,0,0,9,2 (2ct 0st),0.166,
46,Rahat Ali (PAK),2013-2018,21,40,9,9,0,0,9,1 (1ct 0st),0.225,
47,S Ramadhin (WI),1950-1961,43,82,9,9,0,0,9,2 (2ct 0st),0.109,
48,Raqibul Hasan (BAN),2008-2011,9,17,9,9,0,0,9,2 (2ct 0st),0.529,
49,RJ Ratnayake (SL),1983-1992,23,36,9,9,0,0,9,1 (1ct 0st),0.25,
0,JF Reid (NZ),1979-1986,19,35,9,9,0,0,9,3 (3ct 0st),0.257,
1,AME Roberts (WI),1974-1983,47,90,9,9,0,0,9,1 (1ct 0st),0.1,
2,Shadman Islam (BAN),2018-2022,12,18,9,9,0,0,9,4 (4ct 0st),0.5,
3,Shahadat Hossain (BAN),2005-2015,38,63,9,9,0,0,9,1 (1ct 0st),0.142,
4,S Shillingford (WI),2010-2014,16,29,9,9,0,0,9,1 (1ct 0st),0.31,
5,NS Sidhu (INDIA),1983-1999,51,90,9,9,0,0,9,2 (2ct 0st),0.1,
6,JH Sinclair (SA),1896-1911,25,46,9,9,0,0,9,1 (1ct 0st),0.195,
7,L Sivaramakrishnan (INDIA),1983-1986,9,16,9,9,0,0,9,2 (2ct 0st),0.562,
8,GC Small (ENG),1986-1991,17,32,9,9,0,0,9,2 (2ct 0st),0.281,
9,DR Smith (WI),2004-2006,10,18,9,9,0,0,9,3 (3ct 0st),0.5,
10,OG Smith (WI),1955-1959,26,46,9,9,0,0,9,2 (2ct 0st),0.195,
11,RT Stanyforth (ENG),1927-1928,4,8,9,7,2,7,0,3 (3ct 0st),1.125,
12,GTS Stevens (ENG),1922-1930,10,19,9,9,0,0,9,2 (2ct 0st),0.473,
13,V Subramanya (INDIA),1965-1968,9,15,9,9,0,0,9,3 (3ct 0st),0.6,
14,Taslim Arif (PAK),1980-1980,6,10,9,6,3,6,0,2 (1ct 1st),0.9,
15,Tauseef Ahmed (PAK),1980-1993,34,62,9,9,0,0,9,2 (2ct 0st),0.145,
16,PM Toohey (AUS),1977-1980,15,28,9,9,0,0,9,2 (2ct 0st),0.321,
17,L Tuckett (SA),1947-1949,9,17,9,9,0,0,9,2 (2ct 0st),0.529,
18,PA Wallace (WI),1997-1999,7,13,9,9,0,0,9,2 (2ct 0st),0.692,
19,Abdur Rehman (PAK),2007-2014,22,44,8,8,0,0,8,1 (1ct 0st),0.181,
20,HR Adhikari (INDIA),1947-1959,21,30,8,8,0,0,8,2 (2ct 0st),0.266,
21,Akram Raza (PAK),1989-1995,9,15,8,8,0,0,8,2 (2ct 0st),0.533,
22,Alimuddin (PAK),1954-1962,25,43,8,8,0,0,8,2 (2ct 0st),0.186,
23,EG Arnold (ENG),1903-1907,10,19,8,8,0,0,8,2 (2ct 0st),0.421,
24,GA Bartlett (NZ),1961-1968,10,18,8,8,0,0,8,1 (1ct 0st),0.444,
25,CA Best (WI),1986-1990,8,16,8,8,0,0,8,2 (2ct 0st),0.5,
26,MG Bevan (AUS),1994-1998,18,36,8,8,0,0,8,2 (2ct 0st),0.222,
27,JG Binks (ENG),1964-1964,2,4,8,8,0,8,0,5 (5ct 0st),2.0,
28,IR Bishop (WI),1989-1998,43,79,8,8,0,0,8,2 (2ct 0st),0.101,
29,SE Bond (NZ),2001-2009,18,32,8,8,0,0,8,1 (1ct 0st),0.25,
30,TT Bresnan (ENG),2009-2013,23,43,8,8,0,0,8,1 (1ct 0st),0.186,
31,SSJ Brooks (WI),2019-2020,8,14,8,8,0,1,7,2 (2ct 0st),0.571,
32,JD Campbell (WI),2019-2021,15,28,8,8,0,0,8,1 (1ct 0st),0.285,
33,T Campbell (SA),1910-1912,5,9,8,7,1,7,0,2 (2ct 0st),0.888,
34,HB Cave (NZ),1949-1958,19,27,8,8,0,0,8,2 (2ct 0st),0.296,
35,BB Chari (ZIM),2014-2018,7,13,8,8,0,3,5,3 (3ct 0st),0.615,
36,WL Cornford (ENG),1930-1930,4,6,8,5,3,5,0,3 (2ct 1st),1.333,
37,A Cotter (AUS),1904-1912,21,40,8,8,0,0,8,2 (2ct 0st),0.2,
38,CEH Croft (WI),1977-1982,27,52,8,8,0,0,8,2 (2ct 0st),0.153,
39,LS Darling (AUS),1933-1937,12,23,8,8,0,0,8,3 (3ct 0st),0.347,
40,HG Deane (SA),1924-1931,17,27,8,8,0,0,8,2 (2ct 0st),0.296,
41,D Denton (ENG),1905-1910,11,21,8,8,0,0,8,2 (2ct 0st),0.38,
42,ST Finn (ENG),2010-2016,36,68,8,8,0,0,8,2 (2ct 0st),0.117,
43,TJ Franklin (NZ),1983-1991,21,35,8,8,0,0,8,2 (2ct 0st),0.228,
44,N Gifford (ENG),1964-1973,15,27,8,8,0,0,8,1 (1ct 0st),0.296,
45,GJ Gilmour (AUS),1973-1977,15,29,8,8,0,0,8,2 (2ct 0st),0.275,
46,DR Hadlee (NZ),1969-1978,26,45,8,8,0,0,8,2 (2ct 0st),0.177,
47,S Haigh (ENG),1899-1912,11,19,8,8,0,0,8,2 (2ct 0st),0.421,
48,AD Hales (ENG),2015-2016,11,21,8,8,0,0,8,2 (2ct 0st),0.38,
49,MS Harris (AUS),2018-2022,14,27,8,8,0,0,8,2 (2ct 0st),0.296,
0,WK Hegg (ENG),1998-1999,2,4,8,8,0,8,0,3 (3ct 0st),2.0,
1,PS Heine (SA),1955-1962,14,28,8,8,0,0,8,2 (2ct 0st),0.285,
2,RNS Hobbs (ENG),1967-1971,7,12,8,8,0,0,8,2 (2ct 0st),0.666,
3,JKC Holt (WI),1954-1959,17,32,8,8,0,0,8,2 (2ct 0st),0.25,
4,Imran Tahir (SA),2011-2015,20,38,8,8,0,0,8,1 (1ct 0st),0.21,
5,DJ Insole (ENG),1950-1957,9,18,8,8,0,0,8,3 (3ct 0st),0.444,
6,AS Joseph (WI),2016-2021,17,31,8,8,0,0,8,1 (1ct 0st),0.258,
7,Khurram Manzoor (PAK),2009-2014,16,30,8,8,0,0,8,2 (2ct 0st),0.266,
8,PN Kirsten (SA),1992-1994,12,23,8,8,0,0,8,3 (3ct 0st),0.347,
9,P Krishnamurthy (INDIA),1971-1971,5,10,8,7,1,7,0,2 (2ct 0st),0.8,
10,KMDN Kulasekara (SL),2005-2014,21,40,8,8,0,0,8,2 (2ct 0st),0.2,
11,B Kumar (INDIA),2013-2018,21,38,8,8,0,0,8,2 (2ct 0st),0.21,
12,CB Lambert (WI),1991-1998,5,10,8,8,0,0,8,3 (3ct 0st),0.8,
13,ACB Langton (SA),1935-1939,15,23,8,8,0,0,8,1 (1ct 0st),0.347,
14,W Larkins (ENG),1980-1991,13,22,8,8,0,0,8,2 (2ct 0st),0.363,
15,FJ Laver (AUS),1899-1909,15,28,8,8,0,0,8,1 (1ct 0st),0.285,
16,DM Lewis (WI),1971-1971,3,6,8,8,0,8,0,4 (4ct 0st),1.333,
17,TC Lowry (NZ),1930-1931,7,11,8,8,0,0,8,2 (2ct 0st),0.727,
18,A Lyth (ENG),2015-2015,7,13,8,8,0,0,8,2 (2ct 0st),0.615,
19,EL McCormick (AUS),1935-1938,12,22,8,8,0,0,8,2 (2ct 0st),0.363,
20,AJW McIntyre (ENG),1950-1955,3,5,8,8,0,7,1,3 (3ct 0st),1.6,
21,TG McMahon (NZ),1955-1956,5,6,8,7,1,7,0,3 (2ct 1st),1.333,
22,Q McMillan (SA),1929-1932,13,23,8,8,0,0,8,2 (2ct 0st),0.347,
23,A Melville (SA),1938-1949,11,20,8,8,0,0,8,2 (2ct 0st),0.4,
24,BD Milburn (NZ),1969-1969,3,5,8,6,2,6,0,3 (3ct 0st),1.6,
25,A Mishra (INDIA),2008-2016,22,40,8,8,0,0,8,1 (1ct 0st),0.2,
26,MV Narasimha Rao (INDIA),1978-1979,4,8,8,8,0,0,8,2 (2ct 0st),1.0,
27,IK Pathan (INDIA),2003-2008,29,54,8,8,0,0,8,1 (1ct 0st),0.148,
28,DBL Powell (WI),2002-2009,37,68,8,8,0,0,8,2 (2ct 0st),0.117,
29,D Ramnarine (WI),1998-2002,12,24,8,8,0,0,8,2 (2ct 0st),0.333,
30,JM Read (ENG),1882-1893,17,33,8,8,0,0,8,1 (1ct 0st),0.242,
31,MT Renshaw (AUS),2016-2018,11,21,8,8,0,0,8,1 (1ct 0st),0.38,
32,RT Robinson (ENG),1984-1989,29,49,8,8,0,0,8,1 (1ct 0st),0.163,
33,CAG Russell (ENG),1920-1923,10,16,8,8,0,0,8,3 (3ct 0st),0.5,
34,RG Samuels (WI),1996-1997,6,12,8,8,0,0,8,2 (2ct 0st),0.666,
35,HJH Scott (AUS),1884-1886,8,13,8,8,0,0,8,2 (2ct 0st),0.615,
36,Shujauddin (PAK),1954-1962,19,34,8,8,0,0,8,1 (1ct 0st),0.235,
37,Shuvagata Hom (BAN),2014-2016,8,14,8,8,0,0,8,2 (2ct 0st),0.571,
38,BW Sinclair (NZ),1963-1968,21,37,8,8,0,0,8,2 (2ct 0st),0.216,
39,GB Studd (ENG),1882-1883,4,8,8,8,0,0,8,3 (3ct 0st),1.0,
40,ML Su'a (NZ),1992-1995,13,22,8,8,0,0,8,2 (2ct 0st),0.363,
41,R Tattersall (ENG),1951-1954,16,30,8,8,0,0,8,2 (2ct 0st),0.266,
42,JE Taylor (WI),2003-2016,46,81,8,8,0,0,8,1 (1ct 0st),0.098,
43,AJ Traicos (SA/ZIM),1970-1993,7,12,8,8,0,0,8,4 (4ct 0st),0.666,
44,CTB Turner (AUS),1887-1895,17,30,8,8,0,0,8,2 (2ct 0st),0.266,
45,JM Vince (ENG),2016-2018,13,24,8,8,0,0,8,2 (2ct 0st),0.333,
46,W Watson (ENG),1951-1959,23,44,8,8,0,0,8,1 (1ct 0st),0.181,
47,AR Whittall (ZIM),1996-1999,10,16,8,8,0,0,8,3 (3ct 0st),0.5,
48,MA Wood (ENG),2015-2022,25,48,8,8,0,0,8,1 (1ct 0st),0.166,
49,TS Worthington (ENG),1930-1937,9,15,8,8,0,0,8,1 (1ct 0st),0.533,
0,RA Young (NZ),2011-2011,5,10,8,8,0,8,0,2 (2ct 0st),0.8,
1,Aftab Ahmed (BAN),2004-2010,16,23,7,7,0,0,7,2 (2ct 0st),0.304,
2,JC Alabaster (NZ),1955-1972,21,35,7,7,0,0,7,1 (1ct 0st),0.2,
3,Inshan Ali (WI),1971-1977,12,23,7,7,0,0,7,2 (2ct 0st),0.304,
4,CJ Anderson (NZ),2013-2016,13,25,7,7,0,0,7,2 (2ct 0st),0.28,
5,WE Astill (ENG),1927-1930,9,18,7,7,0,0,7,1 (1ct 0st),0.388,
6,Hon.IFW Bligh (ENG),1882-1883,4,8,7,7,0,0,7,2 (2ct 0st),0.875,
7,DJ Brown (ENG),1965-1969,26,46,7,7,0,0,7,2 (2ct 0st),0.152,
8,JT Brown (ENG),1894-1899,8,15,7,7,0,1,6,1 (1ct 0st),0.466,
9,JJ Bumrah (INDIA),2018-2022,27,53,7,7,0,0,7,1 (1ct 0st),0.132,
10,MA Carberry (ENG),2010-2014,6,12,7,7,0,0,7,1 (1ct 0st),0.583,
11,UDU Chandana (SL),1999-2005,16,30,7,7,0,0,7,1 (1ct 0st),0.233,
12,EJ Chatfield (NZ),1975-1989,43,75,7,7,0,0,7,2 (2ct 0st),0.093,
13,CM Christiani (WI),1935-1935,4,8,7,6,1,6,0,3 (2ct 1st),0.875,
14,PT Collins (WI),1999-2006,32,61,7,7,0,0,7,1 (1ct 0st),0.114,
15,NRD Compton (ENG),2012-2016,16,29,7,7,0,0,7,2 (2ct 0st),0.241,
16,JF Crapp (ENG),1948-1949,7,13,7,7,0,0,7,2 (2ct 0st),0.538,
17,JL Denly (ENG),2019-2020,15,29,7,7,0,0,7,1 (1ct 0st),0.241,
18,Dilawar Hussain (INDIA),1934-1936,3,6,7,6,1,6,0,3 (3ct 0st),1.166,
19,MP Donnelly (NZ),1937-1949,7,12,7,7,0,0,7,2 (2ct 0st),0.583,
20,GN Edwards (NZ),1977-1981,8,13,7,7,0,7,0,3 (3ct 0st),0.538,
21,R Edwards (AUS),1972-1975,20,39,7,7,0,0,7,2 (2ct 0st),0.179,
22,SM Ervine (ZIM),2003-2004,5,6,7,7,0,0,7,2 (2ct 0st),1.166,
23,W Farrimond (ENG),1931-1935,4,8,7,5,2,5,0,2 (0ct 2st),0.875,
24,AJ Finch (AUS),2018-2018,5,10,7,7,0,0,7,4 (4ct 0st),0.7,
25,NA Foster (ENG),1983-1993,29,50,7,7,0,0,7,1 (1ct 0st),0.14,
26,GN Francis (WI),1928-1933,10,13,7,7,0,0,7,2 (2ct 0st),0.538,
27,KJ Funston (SA),1952-1958,18,34,7,7,0,0,7,2 (2ct 0st),0.205,
28,TW Garrett (AUS),1877-1888,19,34,7,7,0,0,7,1 (1ct 0st),0.205,
29,H Hameed (ENG),2016-2022,10,19,7,7,0,0,7,3 (3ct 0st),0.368,
30,Hannan Sarkar (BAN),2002-2004,17,26,7,7,0,0,7,2 (2ct 0st),0.269,
31,SJ Harmison (ENG/ICC),2002-2009,63,115,7,7,0,0,7,1 (1ct 0st),0.06,
32,UC Hathurusingha (SL),1991-1999,26,44,7,7,0,0,7,1 (1ct 0st),0.159,
33,FC Hayes (ENG),1973-1976,9,15,7,7,0,0,7,2 (2ct 0st),0.466,
34,DW Headley (ENG),1997-1999,15,25,7,7,0,0,7,1 (1ct 0st),0.28,
35,SO Hetmyer (WI),2017-2019,16,29,7,7,0,0,7,2 (2ct 0st),0.241,
36,BW Hilfenhaus (AUS),2009-2012,27,50,7,7,0,0,7,2 (2ct 0st),0.14,
37,RO Hinds (WI),2002-2009,15,27,7,7,0,0,7,2 (2ct 0st),0.259,
38,RM Hogg (AUS),1978-1984,38,69,7,7,0,0,7,1 (1ct 0st),0.101,
39,PM Hornibrook (AUS),1929-1930,6,11,7,7,0,0,7,2 (2ct 0st),0.636,
40,J Humphries (ENG),1908-1908,3,6,7,7,0,7,0,3 (3ct 0st),1.166,
41,Imam-ul-Haq (PAK),2018-2019,11,20,7,7,0,0,7,4 (4ct 0st),0.35,
42,A Jackson (AUS),1929-1931,8,16,7,7,0,0,7,2 (2ct 0st),0.437,
43,Jahurul Islam (BAN),2010-2013,7,13,7,7,0,0,7,2 (2ct 0st),0.538,
44,PA Jaques (AUS),2005-2008,11,22,7,7,0,0,7,2 (2ct 0st),0.318,
45,Javed Burki (PAK),1960-1969,25,42,7,7,0,0,7,2 (2ct 0st),0.166,
46,LR Johnson (WI),2014-2016,9,14,7,7,0,0,7,2 (2ct 0st),0.5,
47,SB Joshi (INDIA),1996-2000,15,28,7,7,0,0,7,1 (1ct 0st),0.25,
48,VG Kambli (INDIA),1993-1995,17,30,7,7,0,0,7,1 (1ct 0st),0.233,
49,HR Lance (SA),1962-1970,13,26,7,7,0,0,7,2 (2ct 0st),0.269,
0,CB Llewellyn (SA),1896-1912,15,26,7,7,0,0,7,2 (2ct 0st),0.269,
1,ML Love (AUS),2002-2003,5,10,7,7,0,0,7,3 (3ct 0st),0.7,
2,SJE Loxton (AUS),1948-1951,12,23,7,7,0,0,7,4 (4ct 0st),0.304,
3,MF Maharoof (SL),2004-2011,22,40,7,7,0,0,7,1 (1ct 0st),0.175,
4,DE Malcolm (ENG),1989-1997,40,73,7,7,0,0,7,1 (1ct 0st),0.095,
5,SL Malinga (SL),2004-2010,30,59,7,7,0,0,7,2 (2ct 0st),0.118,
6,Manzoor Elahi (PAK),1984-1995,6,10,7,7,0,0,7,2 (2ct 0st),0.7,
7,XM Marshall (WI),2005-2009,7,14,7,7,0,0,7,2 (2ct 0st),0.5,
8,S Matsikenyeri (ZIM),2003-2005,8,12,7,7,0,0,7,2 (2ct 0st),0.583,
9,TJ Matthews (AUS),1912-1912,8,12,7,7,0,0,7,2 (2ct 0st),0.583,
10,TMK Mawoyo (ZIM),2011-2016,11,20,7,7,0,0,7,2 (2ct 0st),0.35,
11,VM Merchant (INDIA),1933-1951,10,18,7,7,0,0,7,2 (2ct 0st),0.388,
12,C Milburn (ENG),1966-1969,9,14,7,7,0,0,7,2 (2ct 0st),0.5,
13,Mohammad Abbas (PAK),2017-2021,25,44,7,7,0,0,7,2 (2ct 0st),0.159,
14,Mohammad Rafique (BAN),2000-2008,33,48,7,7,0,0,7,1 (1ct 0st),0.145,
15,Mohammad Sami (PAK),2001-2012,36,66,7,7,0,0,7,2 (2ct 0st),0.106,
16,Mohammed Siraj (INDIA),2020-2022,12,23,7,7,0,0,7,2 (2ct 0st),0.304,
17,S Mushtaq Ali (INDIA),1934-1952,11,19,7,7,0,0,7,1 (1ct 0st),0.368,
18,Nazar Mohammad (PAK),1952-1952,5,8,7,7,0,0,7,2 (2ct 0st),0.875,
19,ASM Oakman (ENG),1956-1956,2,4,7,7,0,0,7,3 (3ct 0st),1.75,
20,IE O'Brien (NZ),2005-2009,22,38,7,7,0,0,7,2 (2ct 0st),0.184,
21,WJ O'Reilly (AUS),1932-1946,27,50,7,7,0,0,7,2 (2ct 0st),0.14,
22,HH Pandya (INDIA),2017-2018,11,21,7,7,0,0,7,1 (1ct 0st),0.333,
23,E Paynter (ENG),1931-1939,20,37,7,7,0,0,7,1 (1ct 0st),0.189,
24,JSE Price (ENG),1964-1972,15,28,7,7,0,0,7,2 (2ct 0st),0.25,
25,AMB Rowan (SA),1947-1951,15,28,7,7,0,0,7,2 (2ct 0st),0.25,
26,Sami Aslam (PAK),2015-2017,13,25,7,7,0,0,7,2 (2ct 0st),0.28,
27,VJ Scott (NZ),1946-1952,10,14,7,7,0,0,7,2 (2ct 0st),0.5,
28,JED Sealy (WI),1930-1939,11,21,7,6,1,4,2,2 (1ct 1st),0.333,
29,Shamsur Rahman (BAN),2014-2014,6,11,7,7,0,0,7,2 (2ct 0st),0.636,
30,C Sharma (INDIA),1984-1989,23,40,7,7,0,0,7,1 (1ct 0st),0.175,
31,M Sherwin (ENG),1887-1888,3,6,7,5,2,5,0,4 (2ct 2st),1.166,
32,IJ Siedle (SA),1928-1936,18,29,7,7,0,0,7,2 (2ct 0st),0.241,
33,Sikander Bakht (PAK),1976-1983,26,48,7,7,0,0,7,1 (1ct 0st),0.145,
34,LPC Silva (SL),2006-2008,11,21,7,7,0,0,7,2 (2ct 0st),0.333,
35,MC Snedden (NZ),1981-1990,25,42,7,7,0,0,7,2 (2ct 0st),0.166,
36,DS Steele (ENG),1975-1976,8,16,7,7,0,0,7,2 (2ct 0st),0.437,
37,JWA Taylor (ENG),2012-2016,7,13,7,7,0,0,7,2 (2ct 0st),0.538,
38,SA Thomson (NZ),1990-1995,19,31,7,7,0,0,7,1 (1ct 0st),0.225,
39,EWT Tindill (NZ),1937-1947,5,8,7,6,1,6,0,2 (2ct 0st),0.875,
40,PHJ Trimborn (SA),1967-1970,4,8,7,7,0,0,7,2 (2ct 0st),0.875,
41,TR Veivers (AUS),1963-1967,21,38,7,7,0,0,7,2 (2ct 0st),0.184,
42,Wajahatullah Wasti (PAK),1999-2000,6,10,7,7,0,0,7,3 (3ct 0st),0.7,
43,WW Whysall (ENG),1925-1930,4,7,7,7,0,0,7,2 (2ct 0st),1.0,
44,WM Woodfull (AUS),1926-1934,35,65,7,7,0,0,7,2 (2ct 0st),0.107,
45,RD Woolley (AUS),1983-1984,2,3,7,7,0,7,0,3 (3ct 0st),2.333,
46,Abid Ali (PAK),2019-2021,16,28,6,6,0,0,6,3 (3ct 0st),0.214,
47,EE Achong (WI),1930-1935,6,9,6,6,0,0,6,1 (1ct 0st),0.666,
48,CJ Adams (ENG),1999-2000,5,7,6,6,0,0,6,3 (3ct 0st),0.857,
49,AB Agarkar (INDIA),1998-2006,26,48,6,6,0,0,6,1 (1ct 0st),0.125,
0,HK Badani (INDIA),2001-2001,4,7,6,6,0,0,6,2 (2ct 0st),0.857,
1,AA Baig (INDIA),1959-1967,10,17,6,6,0,0,6,1 (1ct 0st),0.352,
2,OAC Banks (WI),2003-2005,10,20,6,6,0,0,6,3 (3ct 0st),0.3,
3,Basit Ali (PAK),1993-1995,19,35,6,6,0,0,6,1 (1ct 0st),0.171,
4,AJ Bell (SA),1929-1935,16,27,6,6,0,0,6,1 (1ct 0st),0.222,
5,TL Best (WI),2003-2013,25,46,6,6,0,0,6,1 (1ct 0st),0.13,
6,C Blythe (ENG),1901-1910,19,37,6,6,0,0,6,1 (1ct 0st),0.162,
7,RS Bopara (ENG),2007-2012,13,20,6,6,0,0,6,2 (2ct 0st),0.3,
8,JR Bracey (ENG),2021-2021,2,4,6,6,0,6,0,2 (2ct 0st),1.5,
9,GE Bradburn (NZ),1990-2001,7,11,6,6,0,0,6,2 (2ct 0st),0.545,
10,W Brockwell (ENG),1893-1899,7,13,6,6,0,0,6,1 (1ct 0st),0.461,
11,DJ Capel (ENG),1987-1990,15,24,6,6,0,0,6,2 (2ct 0st),0.25,
12,W Carkeek (AUS),1912-1912,6,9,6,6,0,6,0,2 (2ct 0st),0.666,
13,E Chigumbura (ZIM),2004-2014,14,24,6,6,0,0,6,2 (2ct 0st),0.25,
14,WM Clark (AUS),1977-1979,10,18,6,6,0,0,6,1 (1ct 0st),0.333,
15,CD Collymore (WI),1999-2007,30,58,6,6,0,0,6,1 (1ct 0st),0.103,
16,SC Cook (SA),2016-2017,11,20,6,6,0,0,6,2 (2ct 0st),0.3,
17,V Dahiya (INDIA),2000-2000,2,4,6,6,0,6,0,3 (3ct 0st),1.5,
18,RL Dias (SL),1982-1987,20,30,6,6,0,0,6,2 (2ct 0st),0.2,
19,AIC Dodemaide (AUS),1987-1992,10,17,6,6,0,0,6,2 (2ct 0st),0.352,
20,PA Emery (AUS),1994-1994,1,2,6,5,1,5,0,5 (4ct 1st),3.0,
21,FL Fane (ENG),1906-1910,14,27,6,6,0,0,6,1 (1ct 0st),0.222,
22,CV Gadkari (INDIA),1953-1955,6,10,6,6,0,0,6,3 (3ct 0st),0.6,
23,DRA Gehrs (AUS),1904-1911,6,11,6,6,0,0,6,2 (2ct 0st),0.545,
24,Y Goonasekera (SL),1983-1983,2,3,6,6,0,0,6,4 (4ct 0st),2.0,
25,AH Gray (WI),1986-1987,5,10,6,6,0,0,6,3 (3ct 0st),0.6,
26,EJ Gray (NZ),1983-1988,10,17,6,6,0,0,6,2 (2ct 0st),0.352,
27,DAS Gunaratne (SL),2016-2017,6,12,6,6,0,0,6,2 (2ct 0st),0.5,
28,MD Gunathilaka (SL),2017-2018,8,15,6,6,0,0,6,1 (1ct 0st),0.4,
29,WA Hadlee (NZ),1937-1951,11,17,6,6,0,0,6,2 (2ct 0st),0.352,
30,PGZ Harris (NZ),1955-1965,9,15,6,6,0,0,6,3 (3ct 0st),0.4,
31,Hasan Ali (PAK),2017-2021,17,33,6,6,0,0,6,1 (1ct 0st),0.181,
32,MJ Henry (NZ),2015-2021,14,27,6,6,0,0,6,2 (2ct 0st),0.222,
33,TP Horan (AUS),1877-1885,15,28,6,6,0,0,6,1 (1ct 0st),0.214,
34,HV Hordern (AUS),1911-1912,7,13,6,6,0,0,6,2 (2ct 0st),0.461,
35,Ibrahim Zadran (AFG),2019-2021,4,8,6,6,0,0,6,2 (2ct 0st),0.75,
36,SMS Kaluperuma (SL),1984-1988,4,6,6,6,0,0,6,2 (2ct 0st),1.0,
37,CK Kapugedera (SL),2006-2009,8,15,6,6,0,0,6,2 (2ct 0st),0.4,
38,MF Kent (AUS),1981-1981,3,6,6,6,0,0,6,3 (3ct 0st),1.0,
39,R Kilner (ENG),1924-1926,9,13,6,6,0,0,6,2 (2ct 0st),0.461,
40,James Langridge (ENG),1933-1946,8,15,6,6,0,0,6,2 (2ct 0st),0.4,
41,CN McCarthy (SA),1948-1951,15,26,6,6,0,0,6,1 (1ct 0st),0.23,
42,PS McDonnell (AUS),1880-1888,19,34,6,6,0,0,6,2 (2ct 0st),0.176,
43,PJ Martin (ENG),1995-1997,8,13,6,6,0,0,6,1 (1ct 0st),0.461,
44,TBA May (AUS),1987-1995,24,46,6,6,0,0,6,1 (1ct 0st),0.13,
45,Mehrab Hossain (BAN),2000-2003,9,11,6,6,0,2,4,2 (2ct 0st),0.545,
46,CR Miller (AUS),1998-2001,18,34,6,6,0,0,6,1 (1ct 0st),0.176,
47,FM Misson (AUS),1960-1961,5,10,6,6,0,0,6,2 (2ct 0st),0.6,
48,Mohammad Ilyas (PAK),1964-1969,10,19,6,6,0,0,6,2 (2ct 0st),0.315,
49,Mohammad Mithun (BAN),2018-2021,10,15,6,6,0,0,6,1 (1ct 0st),0.4,
0,A Mukund (INDIA),2011-2017,7,14,6,6,0,0,6,2 (2ct 0st),0.428,
1,AD Mullally (ENG),1996-2001,19,34,6,6,0,0,6,1 (1ct 0st),0.176,
2,DJ Murray (NZ),1994-1995,8,14,6,6,0,0,6,2 (2ct 0st),0.428,
3,Mushfiqur Rahman (BAN),2001-2004,10,15,6,6,0,0,6,2 (2ct 0st),0.4,
4,Nadeem Abbasi (PAK),1989-1989,3,5,6,6,0,6,0,2 (2ct 0st),1.2,
5,KK Nair (INDIA),2016-2017,6,12,6,6,0,0,6,2 (2ct 0st),0.5,
6,BP Nash (WI),2008-2011,21,37,6,6,0,0,6,1 (1ct 0st),0.162,
7,LJ Nash (AUS),1932-1937,2,4,6,6,0,0,6,2 (2ct 0st),1.5,
8,L Ngidi (SA),2018-2022,13,25,6,6,0,0,6,1 (1ct 0st),0.24,
9,SB O'Connor (NZ),1997-2001,19,35,6,6,0,0,6,2 (2ct 0st),0.171,
10,ML Page (NZ),1930-1937,14,22,6,6,0,0,6,2 (2ct 0st),0.272,
11,BH Pairaudeau (WI),1953-1957,13,25,6,6,0,0,6,1 (1ct 0st),0.24,
12,JT Partridge (SA),1963-1965,11,20,6,6,0,0,6,1 (1ct 0st),0.3,
13,AY Patel (NZ),2018-2021,11,21,6,6,0,0,6,2 (2ct 0st),0.285,
14,MM Patel (INDIA),2006-2011,13,25,6,6,0,0,6,2 (2ct 0st),0.24,
15,KR Patterson (AUS),2019-2019,2,4,6,6,0,0,6,2 (2ct 0st),1.5,
16,JL Pattinson (AUS),2011-2020,21,40,6,6,0,0,6,1 (1ct 0st),0.15,
17,DB Pithey (SA),1963-1967,8,16,6,6,0,0,6,2 (2ct 0st),0.375,
18,BKV Prasad (INDIA),1996-2001,33,59,6,6,0,0,6,1 (1ct 0st),0.101,
19,KTGD Prasad (SL),2008-2015,25,47,6,6,0,0,6,2 (2ct 0st),0.127,
20,SLV Raju (INDIA),1990-2001,28,52,6,6,0,0,6,1 (1ct 0st),0.115,
21,WV Raman (INDIA),1988-1997,11,21,6,6,0,0,6,2 (2ct 0st),0.285,
22,CPH Ramanayake (SL),1988-1993,18,30,6,6,0,0,6,1 (1ct 0st),0.2,
23,FL Reifer (WI),1997-2009,6,12,6,6,0,0,6,2 (2ct 0st),0.5,
24,PE Richardson (ENG),1956-1963,34,65,6,6,0,0,6,1 (1ct 0st),0.092,
25,JDB Robertson (ENG),1947-1952,11,19,6,6,0,0,6,1 (1ct 0st),0.315,
26,PADLR Sandakan (SL),2016-2018,11,21,6,6,0,0,6,1 (1ct 0st),0.285,
27,S Shivnarine (WI),1978-1979,8,13,6,6,0,0,6,2 (2ct 0st),0.461,
28,Shubman Gill (INDIA),2020-2021,10,20,6,6,0,0,6,1 (1ct 0st),0.3,
29,JM Sims (ENG),1935-1937,4,8,6,6,0,0,6,3 (3ct 0st),0.75,
30,RP Singh (INDIA),2006-2011,14,25,6,6,0,0,6,1 (1ct 0st),0.24,
31,MJ Stewart (ENG),1962-1964,8,16,6,6,0,0,6,2 (2ct 0st),0.375,
32,AE Stoddart (ENG),1888-1898,16,29,6,6,0,0,6,1 (1ct 0st),0.206,
33,Tapash Baisya (BAN),2002-2005,21,29,6,6,0,0,6,1 (1ct 0st),0.206,
34,Lord Tennyson (ENG),1913-1921,9,16,6,6,0,0,6,2 (2ct 0st),0.375,
35,TL Tsolekile (SA),2004-2004,3,5,6,6,0,6,0,3 (3ct 0st),1.2,
36,MG Vandort (SL),2001-2008,20,39,6,6,0,0,6,1 (1ct 0st),0.153,
37,S van Zyl (SA),2014-2016,12,20,6,6,0,0,6,1 (1ct 0st),0.3,
38,MA Vermeulen (ZIM),2002-2014,9,14,6,6,0,0,6,1 (1ct 0st),0.428,
39,CF Walters (ENG),1933-1934,11,21,6,6,0,0,6,2 (2ct 0st),0.285,
40,JC White (ENG),1921-1931,15,29,6,6,0,0,6,1 (1ct 0st),0.206,
41,GC Wilson (IRE),2018-2019,2,4,6,6,0,6,0,3 (3ct 0st),1.5,
42,B Wood (ENG),1972-1978,12,23,6,6,0,0,6,2 (2ct 0st),0.26,
43,GEC Wood (ENG),1924-1924,3,6,6,5,1,5,0,2 (2ct 0st),1.0,
44,RA Young (ENG),1907-1908,2,4,6,6,0,6,0,2 (2ct 0st),1.5,
45,Alok Kapali (BAN),2002-2006,17,25,5,5,0,0,5,2 (2ct 0st),0.2,
46,Aminul Islam (BAN),2000-2002,13,16,5,5,0,0,5,3 (3ct 0st),0.312,
47,Asif Masood (PAK),1969-1977,16,29,5,5,0,0,5,1 (1ct 0st),0.172,
48,Atiq-uz-Zaman (PAK),2000-2000,1,2,5,5,0,5,0,3 (3ct 0st),2.5,
49,XC Balaskas (SA),1930-1939,9,14,5,5,0,0,5,1 (1ct 0st),0.357,
0,BA Barnett (AUS),1938-1938,4,6,5,3,2,3,0,3 (2ct 1st),0.833,
1,MJ Bennett (AUS),1984-1985,3,5,5,5,0,0,5,1 (1ct 0st),1.0,
2,SW Billings (ENG),2022-2022,1,2,5,5,0,5,0,5 (5ct 0st),2.5,
3,MC Bird (ENG),1910-1914,10,20,5,5,0,0,5,3 (3ct 0st),0.25,
4,RW Blair (NZ),1953-1964,19,28,5,5,0,0,5,1 (1ct 0st),0.178,
5,RC Blunt (NZ),1930-1932,9,14,5,5,0,0,5,2 (2ct 0st),0.357,
6,KD Boyce (WI),1971-1976,21,41,5,5,0,0,5,1 (1ct 0st),0.121,
7,PVD Chameera (SL),2015-2021,12,22,5,5,0,0,5,1 (1ct 0st),0.227,
8,NGB Cook (ENG),1983-1989,15,25,5,5,0,0,5,2 (2ct 0st),0.2,
9,CS Cowdrey (ENG),1984-1988,6,12,5,5,0,0,5,2 (2ct 0st),0.416,
10,CE Cuffy (WI),1994-2002,15,26,5,5,0,0,5,1 (1ct 0st),0.192,
11,SH Curnow (SA),1930-1932,7,11,5,5,0,0,5,3 (3ct 0st),0.454,
12,SM Curran (ENG),2018-2021,24,46,5,5,0,0,5,2 (2ct 0st),0.108,
13,OC da Costa (WI),1930-1935,5,7,5,5,0,0,5,3 (3ct 0st),0.714,
14,EL Dalton (SA),1929-1939,15,26,5,5,0,0,5,2 (2ct 0st),0.192,
15,WM Darling (AUS),1978-1979,14,25,5,5,0,0,5,2 (2ct 0st),0.2,
16,AM de Silva (SL),1993-1993,3,4,5,4,1,4,0,2 (2ct 0st),1.25,
17,DS de Silva (SL),1982-1984,12,19,5,5,0,0,5,2 (2ct 0st),0.263,
18,KSC de Silva (SL),1997-1999,8,14,5,5,0,0,5,2 (2ct 0st),0.357,
19,RV Divecha (INDIA),1951-1952,5,7,5,5,0,0,5,2 (2ct 0st),0.714,
20,TM Dowlin (WI),2009-2010,6,11,5,5,0,0,5,2 (2ct 0st),0.454,
21,NF Druce (ENG),1897-1898,5,8,5,5,0,1,4,2 (2ct 0st),0.625,
22,CE Eksteen (SA),1993-2000,7,14,5,5,0,0,5,1 (1ct 0st),0.357,
23,RMS Eranga (SL),2011-2016,19,36,5,5,0,0,5,1 (1ct 0st),0.138,
24,E Evans (AUS),1881-1886,6,10,5,5,0,0,5,2 (2ct 0st),0.5,
25,AE Fagg (ENG),1936-1939,5,10,5,5,0,0,5,2 (2ct 0st),0.5,
26,N Pradeep (SL),2011-2017,28,53,5,5,0,0,5,1 (1ct 0st),0.094,
27,FGJ Ford (ENG),1894-1895,5,9,5,5,0,0,5,2 (2ct 0st),0.555,
28,CM Francois (SA),1922-1923,5,10,5,5,0,0,5,3 (3ct 0st),0.5,
29,EW Freeman (AUS),1968-1970,11,21,5,5,0,0,5,1 (1ct 0st),0.238,
30,DK Gaekwad (INDIA),1952-1961,11,17,5,5,0,0,5,1 (1ct 0st),0.294,
31,D Gamsy (SA),1970-1970,2,4,5,5,0,5,0,3 (3ct 0st),1.25,
32,AE Greenidge (WI),1978-1979,6,10,5,5,0,0,5,2 (2ct 0st),0.5,
33,AFG Griffith (WI),1997-2000,14,24,5,5,0,0,5,1 (1ct 0st),0.208,
34,SC Griffith (ENG),1948-1949,3,6,5,5,0,5,0,3 (3ct 0st),0.833,
35,W Gunn (ENG),1887-1899,11,21,5,5,0,0,5,2 (2ct 0st),0.238,
36,JN Hamilton (WI),2019-2019,1,2,5,5,0,5,0,3 (3ct 0st),2.5,
37,BR Hartland (NZ),1992-1994,9,15,5,5,0,0,5,3 (3ct 0st),0.333,
38,Hasan Raza (PAK),1996-2005,7,13,5,5,0,0,5,2 (2ct 0st),0.384,
39,CMH Hathorn (SA),1902-1911,12,23,5,5,0,0,5,1 (1ct 0st),0.217,
40,EE Hemmings (ENG),1982-1991,16,28,5,5,0,0,5,1 (1ct 0st),0.178,
41,ND Hirwani (INDIA),1988-1996,17,31,5,5,0,0,5,1 (1ct 0st),0.161,
42,RG Holland (AUS),1984-1986,11,18,5,5,0,0,5,2 (2ct 0st),0.277,
43,DT Hondo (ZIM),2001-2005,9,13,5,5,0,0,5,2 (2ct 0st),0.384,
44,EAC Hunte (WI),1930-1930,3,6,5,5,0,5,0,3 (3ct 0st),0.833,
45,Ijaz Butt (PAK),1959-1962,8,13,5,5,0,2,3,2 (2ct 0st),0.384,
46,Ikram Alikhil (AFG),2019-2019,1,2,5,4,1,4,0,3 (2ct 1st),2.5,
47,RK Illingworth (ENG),1991-1995,9,14,5,5,0,0,5,2 (2ct 0st),0.357,
48,A Jadeja (INDIA),1992-2000,15,25,5,5,0,0,5,2 (2ct 0st),0.2,
49,TJ Jenner (AUS),1970-1975,9,18,5,5,0,0,5,2 (2ct 0st),0.277,
0,CB Jennings (AUS),1912-1912,6,9,5,5,0,0,5,2 (2ct 0st),0.555,
1,VWC Jupp (ENG),1921-1928,8,15,5,5,0,0,5,1 (1ct 0st),0.333,
2,AS Kennedy (ENG),1922-1923,5,9,5,5,0,0,5,2 (2ct 0st),0.555,
3,D Kenyon (ENG),1951-1955,8,15,5,5,0,0,5,2 (2ct 0st),0.333,
4,CL King (WI),1976-1980,9,17,5,5,0,0,5,2 (2ct 0st),0.294,
5,FM King (WI),1953-1956,14,26,5,5,0,0,5,2 (2ct 0st),0.192,
6,CBRLS Kumara (SL),2016-2021,23,39,5,5,0,0,5,1 (1ct 0st),0.128,
7,R Lamba (INDIA),1986-1987,4,7,5,5,0,0,5,3 (3ct 0st),0.714,
8,GR Larsen (NZ),1994-1996,8,15,5,5,0,0,5,2 (2ct 0st),0.333,
9,JDF Larter (ENG),1962-1965,10,20,5,5,0,0,5,2 (2ct 0st),0.25,
10,RT Latham (NZ),1992-1993,4,8,5,5,0,0,5,2 (2ct 0st),0.625,
11,JD Lindsay (SA),1947-1947,3,6,5,4,1,4,0,2 (1ct 1st),0.833,
12,FA Lowson (ENG),1951-1955,7,12,5,5,0,0,5,2 (2ct 0st),0.416,
13,GG Macaulay (ENG),1923-1933,8,14,5,5,0,0,5,1 (1ct 0st),0.357,
14,PE McEwan (NZ),1980-1984,4,8,5,5,0,0,5,2 (2ct 0st),0.625,
15,NAM McLean (WI),1998-2001,19,33,5,5,0,0,5,1 (1ct 0st),0.151,
16,EDAS McMorris (WI),1958-1966,13,25,5,5,0,0,5,1 (1ct 0st),0.2,
17,Mahmood Hussain (PAK),1952-1962,27,45,5,5,0,0,5,1 (1ct 0st),0.111,
18,JAH Marshall (NZ),2005-2008,7,13,5,5,0,0,5,1 (1ct 0st),0.384,
19,JW Martin (AUS),1960-1967,8,16,5,5,0,0,5,3 (3ct 0st),0.312,
20,EA Martindale (WI),1933-1939,10,17,5,5,0,0,5,1 (1ct 0st),0.294,
21,HH Massie (AUS),1881-1885,9,17,5,5,0,0,5,1 (1ct 0st),0.294,
22,GJ Maxwell (AUS),2013-2017,7,12,5,5,0,0,5,2 (2ct 0st),0.416,
23,KR Mayers (WI),2021-2021,10,19,5,5,0,0,5,2 (2ct 0st),0.263,
24,CA Milton (ENG),1958-1959,6,12,5,5,0,0,5,2 (2ct 0st),0.416,
25,DJ Mitchell (NZ),2019-2022,7,13,5,5,0,0,5,2 (2ct 0st),0.384,
26,Mohammad Amir (PAK),2009-2019,36,69,5,5,0,0,5,1 (1ct 0st),0.072,
27,Mohammad Sharif (BAN),2001-2007,10,12,5,5,0,0,5,2 (2ct 0st),0.416,
28,CH Morris (SA),2016-2017,4,8,5,5,0,0,5,2 (2ct 0st),0.625,
29,A Nehra (INDIA),1999-2004,17,30,5,5,0,0,5,1 (1ct 0st),0.166,
30,AD Ogilvie (AUS),1977-1978,5,10,5,5,0,0,5,1 (1ct 0st),0.5,
31,NV Ojha (INDIA),2015-2015,1,2,5,4,1,4,0,3 (2ct 1st),2.5,
32,GAE Paine (ENG),1935-1935,4,7,5,5,0,0,5,2 (2ct 0st),0.714,
33,BP Patterson (WI),1986-1992,28,54,5,5,0,0,5,1 (1ct 0st),0.092,
34,TRO Payne (WI),1986-1986,1,2,5,5,0,5,0,3 (3ct 0st),2.5,
35,IAR Peebles (ENG),1927-1931,13,21,5,5,0,0,5,1 (1ct 0st),0.238,
36,SJ Pegler (SA),1910-1924,16,24,5,5,0,0,5,2 (2ct 0st),0.208,
37,N Phillip (WI),1978-1979,9,15,5,5,0,0,5,2 (2ct 0st),0.333,
38,PI Philpott (AUS),1965-1966,8,15,5,5,0,0,5,2 (2ct 0st),0.333,
39,DL Piedt (SA),2014-2019,9,16,5,5,0,0,5,2 (2ct 0st),0.312,
40,BA Pocock (NZ),1993-1997,15,24,5,5,0,0,5,1 (1ct 0st),0.208,
41,PH Punjabi (INDIA),1955-1955,5,9,5,5,0,0,5,1 (1ct 0st),0.555,
42,RJ Quiney (AUS),2012-2012,2,4,5,5,0,0,5,2 (2ct 0st),1.25,
43,GO Rabone (NZ),1949-1955,12,19,5,5,0,0,5,2 (2ct 0st),0.263,
44,AJ Redmond (NZ),2008-2013,8,12,5,5,0,0,5,2 (2ct 0st),0.416,
45,BA Reid (AUS),1985-1992,27,46,5,5,0,0,5,1 (1ct 0st),0.108,
46,T Richardson (ENG),1893-1898,14,25,5,5,0,0,5,1 (1ct 0st),0.2,
47,KE Rigg (AUS),1931-1937,8,16,5,5,0,0,5,1 (1ct 0st),0.312,
48,DT Ring (AUS),1948-1953,13,26,5,5,0,0,5,1 (1ct 0st),0.192,
49,CA Roach (WI),1928-1935,16,23,5,5,0,0,5,1 (1ct 0st),0.217,
0,Robiul Islam (BAN),2010-2014,9,17,5,5,0,0,5,1 (1ct 0st),0.294,
1,SD Robson (ENG),2014-2014,7,14,5,5,0,0,5,1 (1ct 0st),0.357,
2,L Ronchi (NZ),2015-2016,4,8,5,5,0,5,0,2 (2ct 0st),0.625,
3,IDK Salisbury (ENG),1992-2000,15,27,5,5,0,0,5,2 (2ct 0st),0.185,
4,DP Samaraweera (SL),1993-1995,7,9,5,5,0,0,5,2 (2ct 0st),0.555,
5,JV Saunders (AUS),1902-1908,14,27,5,5,0,0,5,2 (2ct 0st),0.185,
6,Shafqat Rana (PAK),1964-1969,5,9,5,5,0,0,5,2 (2ct 0st),0.555,
7,Shahid Nazir (PAK),1996-2007,15,29,5,5,0,0,5,2 (2ct 0st),0.172,
8,RJ Sidebottom (ENG),2001-2010,22,37,5,5,0,0,5,1 (1ct 0st),0.135,
9,Sikandar Raza (ZIM),2013-2021,17,30,5,5,0,0,5,1 (1ct 0st),0.166,
10,LMP Simmons (WI),2009-2011,8,15,5,5,0,0,5,1 (1ct 0st),0.333,
11,RT Simpson (ENG),1948-1955,27,51,5,5,0,0,5,2 (2ct 0st),0.098,
12,RR Singh (INDIA),1998-1998,1,2,5,5,0,0,5,3 (3ct 0st),2.5,
13,CL Smith (ENG),1983-1986,8,16,5,5,0,0,5,2 (2ct 0st),0.312,
14,CW Smith (WI),1960-1962,5,10,5,4,1,1,3,3 (3ct 0st),0.5,
15,ET Smith (ENG),2003-2003,3,6,5,5,0,0,5,2 (2ct 0st),0.833,
16,Sohag Gazi (BAN),2012-2014,10,18,5,5,0,0,5,1 (1ct 0st),0.277,
17,S Sreesanth (INDIA),2006-2011,27,50,5,5,0,0,5,2 (2ct 0st),0.1,
18,AG Steel (ENG),1880-1888,13,24,5,5,0,0,5,1 (1ct 0st),0.208,
19,CT Studd (ENG),1882-1883,5,10,5,5,0,0,5,2 (2ct 0st),0.5,
20,R Subba Row (ENG),1958-1961,13,23,5,5,0,0,5,1 (1ct 0st),0.217,
21,PL Symcox (SA),1993-1998,20,35,5,5,0,0,5,2 (2ct 0st),0.142,
22,GJ Thompson (ENG),1909-1910,6,12,5,5,0,0,5,2 (2ct 0st),0.416,
23,RW Tolchard (ENG),1977-1977,4,8,5,5,0,0,5,1 (1ct 0st),0.625,
24,RG Twose (NZ),1995-1999,16,28,5,5,0,0,5,1 (1ct 0st),0.178,
25,KG Viljoen (SA),1930-1949,27,46,5,5,0,0,5,1 (1ct 0st),0.108,
26,Wahab Riaz (PAK),2010-2018,27,52,5,5,0,0,5,1 (1ct 0st),0.096,
27,PM Walker (ENG),1960-1960,3,6,5,5,0,0,5,2 (2ct 0st),0.833,
28,WM Wallace (NZ),1937-1953,13,20,5,5,0,0,5,1 (1ct 0st),0.25,
29,JA Warrican (WI),2015-2021,13,23,5,5,0,0,5,1 (1ct 0st),0.217,
30,Wazir Mohammad (PAK),1952-1959,20,37,5,5,0,0,5,1 (1ct 0st),0.135,
31,UWMBCA Welegedara (SL),2007-2014,21,36,5,5,0,0,5,1 (1ct 0st),0.138,
32,DM Wellham (AUS),1981-1987,6,10,5,5,0,0,5,2 (2ct 0st),0.5,
33,AB Williams (WI),1978-1979,7,12,5,5,0,0,5,2 (2ct 0st),0.416,
34,SMJ Woods (AUS/ENG),1888-1896,6,10,5,5,0,0,5,3 (3ct 0st),0.5,
35,JA Young (ENG),1947-1949,8,14,5,5,0,0,5,1 (1ct 0st),0.357,
36,WA Young (NZ),2020-2022,7,14,5,5,0,0,5,1 (1ct 0st),0.357,
37,Zahid Fazal (PAK),1990-1995,9,16,5,5,0,0,5,1 (1ct 0st),0.312,
38,Zubayr Hamza (SA),2019-2020,5,8,5,5,0,0,5,2 (2ct 0st),0.625,
39,Zulfiqar Ahmed (PAK),1952-1956,9,16,5,5,0,0,5,1 (1ct 0st),0.312,
40,KJ Abbott (SA),2013-2017,11,21,4,4,0,0,4,1 (1ct 0st),0.19,
41,Abdur Razzak (BAN),2006-2018,13,21,4,4,0,0,4,1 (1ct 0st),0.19,
42,EL a'Beckett (AUS),1928-1932,4,8,4,4,0,0,4,2 (2ct 0st),0.5,
43,NAT Adcock (SA),1953-1962,26,48,4,4,0,0,4,1 (1ct 0st),0.083,
44,PJW Allott (ENG),1981-1985,13,24,4,4,0,0,4,1 (1ct 0st),0.166,
45,S Amarnath (INDIA),1976-1978,10,17,4,4,0,0,4,2 (2ct 0st),0.235,
46,SD Anurasiri (SL),1986-1998,18,27,4,4,0,0,4,1 (1ct 0st),0.148,
47,R Appleyard (ENG),1954-1956,9,18,4,4,0,0,4,2 (2ct 0st),0.222,
48,KJ Arnott (ZIM),1992-1993,4,6,4,4,0,0,4,2 (2ct 0st),0.666,
49,HMCM Bandara (SL),1998-2006,8,15,4,4,0,0,4,1 (1ct 0st),0.266,
0,SB Bangar (INDIA),2001-2002,12,22,4,4,0,0,4,1 (1ct 0st),0.181,
1,PT Barton (NZ),1961-1963,7,11,4,4,0,0,4,2 (2ct 0st),0.363,
2,G Bean (ENG),1892-1892,3,6,4,4,0,0,4,2 (2ct 0st),0.666,
3,STR Binny (INDIA),2014-2015,6,9,4,4,0,0,4,1 (1ct 0st),0.444,
4,LS Birkett (WI),1930-1931,4,5,4,4,0,0,4,2 (2ct 0st),0.8,
5,SM Boland (AUS),2021-2022,3,6,4,4,0,0,4,2 (2ct 0st),0.666,
6,EA Brandes (ZIM),1992-1999,10,18,4,4,0,0,4,1 (1ct 0st),0.222,
7,IG Butler (NZ),2002-2004,8,14,4,4,0,0,4,1 (1ct 0st),0.285,
8,MR Bynoe (WI),1959-1967,4,8,4,4,0,0,4,1 (1ct 0st),0.5,
9,GS Camacho (WI),1968-1971,11,18,4,4,0,0,4,1 (1ct 0st),0.222,
10,S Chattergoon (WI),2008-2008,4,8,4,4,0,0,4,1 (1ct 0st),0.5,
11,SR Clark (AUS),2006-2009,24,48,4,4,0,0,4,1 (1ct 0st),0.083,
12,IA Colquhoun (NZ),1955-1955,2,3,4,4,0,4,0,2 (2ct 0st),1.333,
13,WW Daniel (WI),1976-1984,10,20,4,4,0,0,4,1 (1ct 0st),0.2,
14,CA Davis (WI),1968-1973,15,27,4,4,0,0,4,1 (1ct 0st),0.148,
15,HT Davis (NZ),1994-1997,5,9,4,4,0,0,4,1 (1ct 0st),0.444,
16,EAR de Silva (SL),1985-1991,10,16,4,4,0,0,4,1 (1ct 0st),0.25,
17,AJ Doolan (AUS),2014-2014,4,8,4,4,0,0,4,2 (2ct 0st),0.5,
18,CJ Drum (NZ),2001-2002,5,9,4,4,0,0,4,1 (1ct 0st),0.444,
19,MA Ealham (ENG),1996-1998,8,13,4,4,0,0,4,1 (1ct 0st),0.307,
20,MK Elgie (SA),1961-1962,3,6,4,4,0,0,4,2 (2ct 0st),0.666,
21,Faheem Ashraf (PAK),2018-2021,13,24,4,4,0,0,4,1 (1ct 0st),0.166,
22,NH Fairbrother (ENG),1987-1993,10,15,4,4,0,0,4,2 (2ct 0st),0.266,
23,TCB Fernando (SL),2001-2002,9,17,4,4,0,0,4,2 (2ct 0st),0.235,
24,JJ Ferris (AUS/ENG),1887-1892,9,16,4,4,0,0,4,1 (1ct 0st),0.25,
25,A Fielder (ENG),1904-1908,6,12,4,4,0,0,4,2 (2ct 0st),0.333,
26,AP Freeman (ENG),1924-1929,12,23,4,4,0,0,4,1 (1ct 0st),0.173,
27,AB Fudadin (WI),2012-2012,3,5,4,4,0,0,4,2 (2ct 0st),0.8,
28,LH Gay (ENG),1894-1894,1,2,4,3,1,3,0,3 (2ct 1st),2.0,
29,JM Ghorpade (INDIA),1953-1959,8,12,4,4,0,0,4,1 (1ct 0st),0.333,
30,PA Gibb (ENG),1938-1946,8,14,4,3,1,3,0,2 (1ct 1st),0.285,
31,R Gilchrist (WI),1957-1959,13,23,4,4,0,0,4,1 (1ct 0st),0.173,
32,HC Griffith (WI),1928-1933,13,18,4,4,0,0,4,1 (1ct 0st),0.222,
33,NE Haig (ENG),1921-1930,5,10,4,4,0,0,4,2 (2ct 0st),0.4,
34,AE Hall (SA),1923-1931,7,14,4,4,0,0,4,1 (1ct 0st),0.285,
35,M Hayward (SA),1999-2004,16,31,4,4,0,0,4,1 (1ct 0st),0.129,
36,GR Hazlitt (AUS),1907-1912,9,15,4,4,0,0,4,1 (1ct 0st),0.266,
37,JT Hearne (ENG),1892-1899,12,22,4,4,0,0,4,2 (2ct 0st),0.181,
38,K Higgs (ENG),1965-1968,15,27,4,4,0,0,4,1 (1ct 0st),0.148,
39,JW Hitch (ENG),1911-1921,7,12,4,4,0,0,4,1 (1ct 0st),0.333,
40,AJ Hollioake (ENG),1997-1998,4,6,4,4,0,0,4,1 (1ct 0st),0.666,
41,ERT Holmes (ENG),1935-1935,5,9,4,4,0,0,4,2 (2ct 0st),0.444,
42,ND Howard (ENG),1951-1952,4,7,4,4,0,0,4,2 (2ct 0st),0.571,
43,Ihsanullah (AFG),2019-2019,3,6,4,4,0,0,4,2 (2ct 0st),0.666,
44,Imran Nazir (PAK),1999-2002,8,14,4,4,0,0,4,1 (1ct 0st),0.285,
45,RJ Inverarity (AUS),1968-1972,6,12,4,4,0,0,4,2 (2ct 0st),0.333,
46,M Jahangir Khan (INDIA),1932-1936,4,7,4,4,0,0,4,3 (3ct 0st),0.571,
47,KA Jamieson (NZ),2020-2022,12,24,4,4,0,0,4,1 (1ct 0st),0.166,
48,RO Jenkins (ENG),1948-1952,9,18,4,4,0,0,4,1 (1ct 0st),0.222,
49,IJ Jones (ENG),1964-1968,15,27,4,4,0,0,4,1 (1ct 0st),0.148,
0,PEW Jones (WI),1948-1951,9,18,4,4,0,0,4,1 (1ct 0st),0.222,
1,SP Jones (ENG),2002-2005,18,35,4,4,0,0,4,1 (1ct 0st),0.114,
2,BP Julian (AUS),1993-1995,7,14,4,4,0,0,4,1 (1ct 0st),0.285,
3,RR Jumadeen (WI),1972-1979,12,22,4,4,0,0,4,2 (2ct 0st),0.181,
4,Junaid Khan (PAK),2011-2015,22,43,4,4,0,0,4,2 (2ct 0st),0.093,
5,JL Kerr (NZ),1931-1937,7,10,4,4,0,0,4,2 (2ct 0st),0.4,
6,Khan Mohammad (PAK),1952-1958,13,22,4,4,0,0,4,2 (2ct 0st),0.181,
7,H Klaasen (SA),2019-2019,1,1,4,3,1,3,0,4 (3ct 1st),4.0,
8,JJ Krejza (AUS),2008-2008,2,4,4,4,0,0,4,3 (3ct 0st),1.0,
9,AG Kripal Singh (INDIA),1955-1964,14,25,4,4,0,0,4,1 (1ct 0st),0.16,
10,PD Lashley (WI),1960-1966,4,8,4,4,0,0,4,2 (2ct 0st),0.5,
11,WH Lockwood (ENG),1893-1902,12,20,4,4,0,0,4,2 (2ct 0st),0.2,
12,JE McConnon (ENG),1954-1954,2,4,4,4,0,0,4,4 (4ct 0st),1.0,
13,TR McKibbin (AUS),1895-1898,5,10,4,4,0,0,4,2 (2ct 0st),0.4,
14,DL Maddy (ENG),1999-2000,3,5,4,4,0,0,4,1 (1ct 0st),0.8,
15,Manjural Islam (BAN),2001-2004,17,22,4,4,0,0,4,1 (1ct 0st),0.181,
16,FT Mann (ENG),1922-1923,5,9,4,4,0,0,4,1 (1ct 0st),0.444,
17,CR Matthews (SA),1992-1995,18,33,4,4,0,0,4,2 (2ct 0st),0.121,
18,CP Mead (ENG),1911-1928,17,31,4,4,0,0,4,1 (1ct 0st),0.129,
19,MG Melle (SA),1950-1953,7,12,4,4,0,0,4,2 (2ct 0st),0.333,
20,KD Mills (NZ),2004-2009,19,33,4,4,0,0,4,1 (1ct 0st),0.121,
21,Mohammad Akram (PAK),1995-2001,9,15,4,4,0,0,4,1 (1ct 0st),0.266,
22,Mohammad Nazir (PAK),1969-1983,14,23,4,4,0,0,4,1 (1ct 0st),0.173,
23,Mohammad Salim (BAN),2003-2003,2,2,4,3,1,3,0,2 (2ct 0st),2.0,
24,Mohsin Kamal (PAK),1984-1994,9,15,4,4,0,0,4,1 (1ct 0st),0.266,
25,LJ Moon (ENG),1906-1906,4,7,4,4,0,1,3,2 (2ct 0st),0.571,
26,F Morley (ENG),1880-1883,4,8,4,4,0,0,4,2 (2ct 0st),0.5,
27,CB Mpofu (ZIM),2005-2017,15,24,4,4,0,0,4,1 (1ct 0st),0.166,
28,TK Musakanda (ZIM),2017-2021,5,8,4,4,0,0,4,2 (2ct 0st),0.5,
29,Naimur Rahman (BAN),2000-2002,8,11,4,4,0,0,4,2 (2ct 0st),0.363,
30,Nayeem Hasan (BAN),2018-2021,7,13,4,4,0,0,4,3 (3ct 0st),0.307,
31,CK Nayudu (INDIA),1932-1936,7,13,4,4,0,0,4,1 (1ct 0st),0.307,
32,ML Nkala (ZIM),2000-2005,10,17,4,4,0,0,4,2 (2ct 0st),0.235,
33,A Nortje (SA),2019-2021,12,21,4,4,0,0,4,2 (2ct 0st),0.19,
34,Sir TC O'Brien (ENG),1884-1896,5,9,4,4,0,0,4,1 (1ct 0st),0.444,
35,SP O'Donnell (AUS),1985-1985,6,10,4,4,0,0,4,2 (2ct 0st),0.4,
36,S O'Linn (SA),1960-1961,7,13,4,4,0,0,4,2 (2ct 0st),0.307,
37,C Overton (ENG),2017-2021,6,10,4,4,0,0,4,2 (2ct 0st),0.4,
38,HGO Owen-Smith (SA),1929-1929,5,9,4,4,0,0,4,2 (2ct 0st),0.444,
39,RK Oxenham (AUS),1928-1931,7,14,4,4,0,0,4,1 (1ct 0st),0.285,
40,DR Parry (WI),1978-1980,12,21,4,4,0,0,4,1 (1ct 0st),0.19,
41,CT Patankar (INDIA),1955-1956,1,2,4,3,1,3,0,4 (3ct 1st),2.0,
42,CE Pellew (AUS),1920-1921,10,20,4,4,0,0,4,1 (1ct 0st),0.2,
43,PJ Petherick (NZ),1976-1977,6,12,4,4,0,0,4,2 (2ct 0st),0.333,
44,WR Playle (NZ),1958-1963,8,10,4,4,0,0,4,1 (1ct 0st),0.4,
45,RW Price (ZIM),1999-2013,22,37,4,4,0,0,4,2 (2ct 0st),0.108,
46,MJ Procter (SA),1967-1970,7,14,4,4,0,0,4,2 (2ct 0st),0.285,
47,WG Quaife (ENG),1899-1902,7,14,4,4,0,0,4,2 (2ct 0st),0.285,
48,CT Radley (ENG),1978-1978,8,15,4,4,0,0,4,1 (1ct 0st),0.266,
49,Rahmat Shah (AFG),2018-2021,6,11,4,4,0,0,4,1 (1ct 0st),0.363,
0,V Rajindernath (INDIA),1952-1952,1,2,4,0,4,0,0,2 (0ct 2st),2.0,
1,CAK Rajitha (SL),2018-2020,9,15,4,4,0,0,4,3 (3ct 0st),0.266,
2,AU Rashid (ENG),2015-2019,19,36,4,4,0,0,4,1 (1ct 0st),0.111,
3,DM Richards (WI),2009-2010,3,6,4,4,0,0,4,1 (1ct 0st),0.666,
4,Rizwan-uz-Zaman (PAK),1981-1989,11,19,4,4,0,0,4,1 (1ct 0st),0.21,
5,ADG Roberts (NZ),1976-1976,7,14,4,4,0,0,4,1 (1ct 0st),0.285,
6,AW Roberts (NZ),1930-1937,5,9,4,4,0,0,4,1 (1ct 0st),0.444,
7,OE Robinson (ENG),2021-2022,9,17,4,4,0,0,4,1 (1ct 0st),0.235,
8,RD Robinson (AUS),1977-1977,3,5,4,4,0,0,4,1 (1ct 0st),0.8,
9,BC Rose (ENG),1977-1981,9,13,4,4,0,0,4,2 (2ct 0st),0.307,
10,FA Rose (WI),1997-2000,19,33,4,4,0,0,4,2 (2ct 0st),0.121,
11,GA Rowe (SA),1896-1902,5,8,4,4,0,0,4,2 (2ct 0st),0.5,
12,WE Russell (ENG),1961-1967,10,18,4,4,0,0,4,2 (2ct 0st),0.222,
13,S Samarawickrama (SL),2017-2017,4,7,4,4,0,0,4,2 (2ct 0st),0.571,
14,A Sandham (ENG),1921-1930,14,24,4,4,0,0,4,1 (1ct 0st),0.166,
15,A Sanford (WI),2002-2004,11,19,4,4,0,0,4,2 (2ct 0st),0.21,
16,DN Sardesai (INDIA),1961-1972,30,55,4,4,0,0,4,1 (1ct 0st),0.072,
17,WH Scotton (ENG),1881-1887,15,28,4,4,0,0,4,2 (2ct 0st),0.142,
18,Shakeel Ahmed jnr (PAK),1993-1995,3,6,4,4,0,0,4,2 (2ct 0st),0.666,
19,MD Shanaka (SL),2016-2021,6,9,4,4,0,0,4,2 (2ct 0st),0.444,
20,A Shaw (ENG),1877-1882,7,13,4,4,0,0,4,2 (2ct 0st),0.307,
21,JN Shepherd (WI),1969-1971,5,10,4,4,0,0,4,2 (2ct 0st),0.4,
22,MW Sievers (AUS),1936-1937,3,5,4,4,0,0,4,2 (2ct 0st),0.8,
23,PR Sleep (AUS),1979-1990,14,23,4,4,0,0,4,1 (1ct 0st),0.173,
24,RH Spooner (ENG),1905-1912,10,18,4,4,0,0,4,1 (1ct 0st),0.222,
25,PR Stirling (IRE),2018-2019,3,6,4,4,0,0,4,2 (2ct 0st),0.666,
26,PM Such (ENG),1993-1999,11,20,4,4,0,0,4,2 (2ct 0st),0.2,
27,Surendra Nath (INDIA),1958-1961,11,17,4,4,0,0,4,2 (2ct 0st),0.235,
28,Talat Ali (PAK),1972-1979,10,16,4,4,0,0,4,1 (1ct 0st),0.25,
29,DJ Terbrugge (SA),1998-2004,7,14,4,4,0,0,4,1 (1ct 0st),0.285,
30,DT Tiripano (ZIM),2014-2021,15,26,4,4,0,0,4,1 (1ct 0st),0.153,
31,ERH Toshack (AUS),1946-1948,12,24,4,4,0,0,4,1 (1ct 0st),0.166,
32,CT Tremlett (ENG),2007-2013,12,24,4,4,0,0,4,1 (1ct 0st),0.166,
33,AE Trott (AUS/ENG),1895-1899,5,10,4,4,0,0,4,3 (3ct 0st),0.4,
34,FH Tyson (ENG),1954-1959,17,32,4,4,0,0,4,1 (1ct 0st),0.125,
35,JTC Vaughan (NZ),1992-1997,6,9,4,4,0,0,4,2 (2ct 0st),0.444,
36,HG Vivian (NZ),1931-1937,7,11,4,4,0,0,4,1 (1ct 0st),0.363,
37,HF Wade (SA),1935-1936,10,15,4,4,0,0,4,1 (1ct 0st),0.266,
38,W Watson (NZ),1986-1993,15,26,4,4,0,0,4,1 (1ct 0st),0.153,
39,WJ Whitty (AUS),1909-1912,14,25,4,4,0,0,4,1 (1ct 0st),0.16,
40,JM Wiener (AUS),1979-1980,6,10,4,4,0,0,4,2 (2ct 0st),0.4,
41,BA Williams (AUS),2003-2004,4,8,4,4,0,0,4,2 (2ct 0st),0.5,
42,DNT Zoysa (SL),1997-2004,30,51,4,4,0,0,4,1 (1ct 0st),0.078,
43,JW Zulch (SA),1910-1921,16,30,4,4,0,0,4,1 (1ct 0st),0.133,
44,Zulfiqar Babar (PAK),2013-2016,15,28,4,4,0,0,4,1 (1ct 0st),0.142,
45,Abdullah Shafique (PAK),2021-2021,2,4,3,3,0,0,3,2 (2ct 0st),0.75,
46,Abul Hasan (BAN),2012-2013,3,6,3,3,0,0,3,2 (2ct 0st),0.5,
47,Aftab Gul (PAK),1969-1971,6,11,3,3,0,0,3,1 (1ct 0st),0.272,
48,Agha Saadat Ali (PAK),1955-1955,1,2,3,3,0,0,3,2 (2ct 0st),1.5,
49,Ahmed Shehzad (PAK),2013-2017,13,26,3,3,0,0,3,1 (1ct 0st),0.115,
0,Akram Khan (BAN),2000-2003,8,11,3,3,0,0,3,1 (1ct 0st),0.272,
1,CFW Allcott (NZ),1930-1932,6,9,3,3,0,0,3,1 (1ct 0st),0.333,
2,L Amar Singh (INDIA),1932-1936,7,13,3,3,0,0,3,1 (1ct 0st),0.23,
3,AMJG Amerasinghe (SL),1984-1984,2,3,3,3,0,0,3,2 (2ct 0st),1.0,
4,BJ Arnel (NZ),2010-2012,6,12,3,3,0,0,3,1 (1ct 0st),0.25,
5,TD Astle (NZ),2012-2020,5,10,3,3,0,0,3,1 (1ct 0st),0.3,
6,RA Austin (WI),2009-2009,2,4,3,3,0,0,3,2 (2ct 0st),0.75,
7,KBJ Azad (INDIA),1981-1983,7,14,3,3,0,0,3,1 (1ct 0st),0.214,
8,CL Badcock (AUS),1936-1938,7,11,3,3,0,0,3,1 (1ct 0st),0.272,
9,AH Bakewell (ENG),1931-1935,6,12,3,3,0,0,3,2 (2ct 0st),0.25,
10,A Balbirnie (IRE),2018-2019,3,6,3,3,0,0,3,1 (1ct 0st),0.5,
11,SA Banerjee (INDIA),1948-1949,1,2,3,3,0,0,3,2 (2ct 0st),1.5,
12,GJ Batty (ENG),2003-2016,9,16,3,3,0,0,3,2 (2ct 0st),0.187,
13,DM Bess (ENG),2018-2021,14,26,3,3,0,0,3,1 (1ct 0st),0.115,
14,GP Bilby (NZ),1966-1966,2,3,3,3,0,0,3,1 (1ct 0st),1.0,
15,J Birkenshaw (ENG),1973-1974,5,9,3,3,0,0,3,2 (2ct 0st),0.333,
16,M Bisset (SA),1899-1910,3,6,3,2,1,2,0,1 (1ct 0st),0.5,
17,J Botha (SA),2006-2010,5,10,3,3,0,0,3,1 (1ct 0st),0.3,
18,IDR Bradshaw (WI),2006-2006,5,7,3,3,0,0,3,2 (2ct 0st),0.428,
19,VR Brown (NZ),1985-1985,2,4,3,3,0,0,3,2 (2ct 0st),0.75,
20,RO Butcher (ENG),1981-1981,3,4,3,3,0,0,3,2 (2ct 0st),0.75,
21,Hon.FSG Calthorpe (ENG),1930-1930,4,8,3,3,0,0,3,1 (1ct 0st),0.375,
22,PR Carlstein (SA),1958-1964,8,15,3,3,0,0,3,1 (1ct 0st),0.2,
23,AW Carr (ENG),1922-1929,11,16,3,3,0,0,3,1 (1ct 0st),0.187,
24,JAJ Christy (SA),1929-1932,10,17,3,3,0,0,3,1 (1ct 0st),0.176,
25,CK Coventry (ZIM),2005-2005,2,3,3,3,0,0,3,2 (2ct 0st),1.0,
26,J Cowie (NZ),1937-1949,9,14,3,3,0,0,3,2 (2ct 0st),0.214,
27,K Cranston (ENG),1947-1948,8,16,3,3,0,0,3,2 (2ct 0st),0.187,
28,RJ Crisp (SA),1935-1936,9,14,3,3,0,0,3,1 (1ct 0st),0.214,
29,CD Cumming (NZ),2005-2008,11,20,3,3,0,0,3,1 (1ct 0st),0.15,
30,TS Curtis (ENG),1988-1989,5,9,3,3,0,0,3,1 (1ct 0st),0.333,
31,RKJ Dawson (ENG),2001-2003,7,11,3,3,0,0,3,2 (2ct 0st),0.272,
32,JH de Courcy (AUS),1953-1953,3,5,3,3,0,0,3,2 (2ct 0st),0.6,
33,GR Dickinson (NZ),1930-1932,3,6,3,3,0,0,3,2 (2ct 0st),0.5,
34,GHG Doggart (ENG),1950-1950,2,4,3,3,0,0,3,1 (1ct 0st),0.75,
35,B Dooland (AUS),1947-1948,3,6,3,3,0,0,3,1 (1ct 0st),0.5,
36,UG Dowe (WI),1971-1973,4,8,3,3,0,0,3,1 (1ct 0st),0.375,
37,A D'Souza (PAK),1959-1962,6,10,3,3,0,0,3,2 (2ct 0st),0.3,
38,CAR Duckworth (SA),1957-1957,2,4,3,3,0,0,3,1 (1ct 0st),0.75,
39,R Dumbrill (SA),1965-1967,5,10,3,3,0,0,3,1 (1ct 0st),0.3,
40,Enamul Haque jnr (BAN),2003-2013,15,27,3,3,0,0,3,1 (1ct 0st),0.111,
41,Fakhar Zaman (PAK),2018-2019,3,6,3,3,0,0,3,1 (1ct 0st),0.5,
42,MVT Fernando (SL),2016-2021,14,25,3,3,0,0,3,1 (1ct 0st),0.12,
43,MLC Foster (WI),1969-1978,14,26,3,3,0,0,3,1 (1ct 0st),0.115,
44,ERH Fuller (SA),1953-1958,7,12,3,3,0,0,3,1 (1ct 0st),0.25,
45,DJ Gandhi (INDIA),1999-1999,4,8,3,3,0,0,3,1 (1ct 0st),0.375,
46,JB Gannon (AUS),1977-1978,3,5,3,3,0,0,3,2 (2ct 0st),0.6,
47,AER Gilligan (ENG),1922-1925,11,21,3,3,0,0,3,1 (1ct 0st),0.142,
48,TWJ Goddard (ENG),1930-1939,8,13,3,3,0,0,3,1 (1ct 0st),0.23,
49,MJ Gopalan (INDIA),1934-1934,1,2,3,3,0,0,3,2 (2ct 0st),1.5,
0,H Graham (AUS),1893-1896,6,11,3,3,0,0,3,1 (1ct 0st),0.272,
1,GA Greenidge (WI),1972-1973,5,9,3,3,0,0,3,1 (1ct 0st),0.333,
2,Gul Mohammad (INDIA/PAK),1946-1956,9,13,3,3,0,0,3,1 (1ct 0st),0.23,
3,JR Gunn (ENG),1901-1905,6,12,3,3,0,0,3,1 (1ct 0st),0.25,
4,PAM Hands (SA),1913-1924,7,10,3,3,0,0,3,2 (2ct 0st),0.3,
5,MS Hardikar (INDIA),1958-1958,2,4,3,3,0,0,3,2 (2ct 0st),0.75,
6,NM Hauritz (AUS),2004-2010,17,33,3,3,0,0,3,1 (1ct 0st),0.09,
7,Lord Hawke (ENG),1896-1899,5,10,3,3,0,0,3,2 (2ct 0st),0.3,
8,JA Hayes (NZ),1951-1958,15,20,3,3,0,0,3,2 (2ct 0st),0.15,
9,F Hearne (ENG/SA),1889-1896,6,9,3,3,0,0,3,1 (1ct 0st),0.333,
10,GAL Hearne (SA),1922-1924,3,5,3,3,0,0,3,3 (3ct 0st),0.6,
11,C Heseltine (ENG),1896-1896,2,4,3,3,0,0,3,1 (1ct 0st),0.75,
12,JD Higgs (AUS),1978-1981,22,39,3,3,0,0,3,1 (1ct 0st),0.076,
13,DD Hindlekar (INDIA),1936-1946,4,7,3,3,0,3,0,1 (1ct 0st),0.428,
14,TV Hohns (AUS),1989-1989,7,13,3,3,0,0,3,1 (1ct 0st),0.23,
15,P Holmes (ENG),1921-1932,7,14,3,3,0,0,3,2 (2ct 0st),0.214,
16,KA Hope (WI),2017-2017,5,9,3,3,0,0,3,1 (1ct 0st),0.333,
17,PA Horne (NZ),1987-1990,4,7,3,3,0,0,3,1 (1ct 0st),0.428,
18,AG Huckle (ZIM),1997-1998,8,14,3,3,0,0,3,1 (1ct 0st),0.214,
19,AG Hurst (AUS),1974-1979,12,22,3,3,0,0,3,1 (1ct 0st),0.136,
20,P Hutchinson (SA),1889-1889,2,3,3,3,0,0,3,2 (2ct 0st),1.0,
21,Ijaz Ahmed jnr (PAK),1995-1995,2,4,3,3,0,0,3,2 (2ct 0st),0.75,
22,JK Irani (INDIA),1947-1947,2,2,3,2,1,2,0,2 (1ct 1st),1.5,
23,H Ironmonger (AUS),1928-1933,14,28,3,3,0,0,3,2 (2ct 0st),0.107,
24,KM Jarvis (ZIM),2011-2020,13,23,3,3,0,0,3,1 (1ct 0st),0.13,
25,TW Jarvis (NZ),1965-1973,13,24,3,3,0,0,3,2 (2ct 0st),0.125,
26,CEL Jones (WI),1930-1935,4,8,3,3,0,0,3,2 (2ct 0st),0.375,
27,SC Joseph (WI),2004-2007,5,9,3,3,0,0,3,1 (1ct 0st),0.333,
28,KT Kasuza (ZIM),2020-2021,7,11,3,3,0,0,3,1 (1ct 0st),0.272,
29,PHT Kaushal (SL),2014-2015,7,14,3,3,0,0,3,2 (2ct 0st),0.214,
30,JM Kemp (SA),2001-2005,4,8,3,3,0,0,3,1 (1ct 0st),0.375,
31,Khalid Ibadulla (PAK),1964-1967,4,8,3,3,0,0,3,2 (2ct 0st),0.375,
32,RJ Kirtley (ENG),2003-2003,4,7,3,3,0,0,3,1 (1ct 0st),0.428,
33,JJ Kotze (SA),1902-1907,3,5,3,3,0,0,3,1 (1ct 0st),0.6,
34,Kuldeep Yadav (INDIA),2017-2021,7,13,3,3,0,0,3,1 (1ct 0st),0.23,
35,GF Labrooy (SL),1986-1991,9,15,3,3,0,0,3,1 (1ct 0st),0.2,
36,TJ Laughlin (AUS),1978-1978,3,6,3,3,0,0,3,2 (2ct 0st),0.5,
37,JJC Lawson (WI),2002-2005,13,26,3,3,0,0,3,1 (1ct 0st),0.115,
38,E Leadbeater (ENG),1951-1952,2,4,3,3,0,0,3,2 (2ct 0st),0.75,
39,WHV Levett (ENG),1934-1934,1,2,3,3,0,3,0,3 (3ct 0st),1.5,
40,HSB Love (AUS),1933-1933,1,2,3,3,0,3,0,3 (3ct 0st),1.5,
41,JJ Lyons (AUS),1887-1897,14,25,3,3,0,0,3,1 (1ct 0st),0.12,
42,EA McDonald (AUS),1921-1921,11,22,3,3,0,0,3,1 (1ct 0st),0.136,
43,A McGrath (ENG),2003-2003,4,7,3,3,0,0,3,1 (1ct 0st),0.428,
44,RW McLeod (AUS),1892-1893,6,10,3,3,0,0,3,1 (1ct 0st),0.3,
45,ES Maka (INDIA),1952-1953,2,3,3,2,1,2,0,3 (2ct 1st),1.0,
46,PJ Malan (SA),2020-2020,3,5,3,3,0,0,3,1 (1ct 0st),0.6,
47,FG Mann (ENG),1948-1949,7,13,3,3,0,0,3,2 (2ct 0st),0.23,
48,NBF Mann (SA),1947-1951,19,34,3,3,0,0,3,1 (1ct 0st),0.088,
49,GA Manou (AUS),2009-2009,1,1,3,3,0,3,0,3 (3ct 0st),3.0,
0,Manjural Islam Rana (BAN),2004-2004,6,7,3,3,0,0,3,2 (2ct 0st),0.428,
1,JR Mason (ENG),1897-1898,5,8,3,3,0,0,3,1 (1ct 0st),0.375,
2,EH Mattis (WI),1981-1981,4,8,3,3,0,0,3,2 (2ct 0st),0.375,
3,B Mavuta (ZIM),2018-2018,2,4,3,3,0,0,3,2 (2ct 0st),0.75,
4,MP Maynard (ENG),1988-1994,4,8,3,3,0,0,3,1 (1ct 0st),0.375,
5,LC Mayne (AUS),1965-1970,6,12,3,3,0,0,3,1 (1ct 0st),0.25,
6,DJ Meintjes (SA),1923-1923,2,4,3,3,0,0,3,2 (2ct 0st),0.75,
7,RS Modi (INDIA),1946-1952,10,16,3,3,0,0,3,1 (1ct 0st),0.187,
8,Mohammad Asif (PAK),2005-2010,23,45,3,3,0,0,3,1 (1ct 0st),0.066,
9,Mohammad Salman (PAK),2011-2011,2,4,3,2,1,2,0,1 (1ct 0st),0.75,
10,DAR Moloney (NZ),1937-1937,3,6,3,3,0,0,3,2 (2ct 0st),0.5,
11,H Morris (ENG),1991-1991,3,6,3,3,0,0,3,1 (1ct 0st),0.5,
12,JE Morris (ENG),1990-1990,3,5,3,3,0,0,3,2 (2ct 0st),0.6,
13,JB Mortimore (ENG),1959-1964,9,17,3,3,0,0,3,1 (1ct 0st),0.176,
14,S Moseley (WI),2021-2021,2,4,3,3,0,0,3,2 (2ct 0st),0.75,
15,ARA Murray (SA),1952-1954,10,18,3,3,0,0,3,1 (1ct 0st),0.166,
16,D Myers (ZIM),2021-2021,1,2,3,3,0,0,3,2 (2ct 0st),1.5,
17,Naved-ul-Hasan (PAK),2004-2007,9,17,3,3,0,0,3,2 (2ct 0st),0.176,
18,CS Nayudu (INDIA),1934-1952,11,17,3,3,0,0,3,1 (1ct 0st),0.176,
19,C Newberry (SA),1913-1914,4,7,3,3,0,0,3,3 (3ct 0st),0.428,
20,ES Newson (SA),1930-1939,3,6,3,3,0,0,3,2 (2ct 0st),0.5,
21,F Nicholson (SA),1935-1936,4,6,3,3,0,3,0,2 (2ct 0st),0.5,
22,HC Nitschke (AUS),1931-1931,2,4,3,3,0,0,3,1 (1ct 0st),0.75,
23,LPJ O'Brien (AUS),1932-1936,5,9,3,3,0,0,3,2 (2ct 0st),0.333,
24,JDA O'Connor (AUS),1908-1909,4,8,3,3,0,0,3,1 (1ct 0st),0.375,
25,MB Owens (NZ),1992-1994,8,12,3,3,0,0,3,2 (2ct 0st),0.25,
26,T Panyangara (ZIM),2004-2014,9,16,3,3,0,0,3,2 (2ct 0st),0.187,
27,WGA Parkhouse (ENG),1950-1959,7,13,3,3,0,0,3,1 (1ct 0st),0.23,
28,CH Parkin (ENG),1920-1924,10,17,3,3,0,0,3,2 (2ct 0st),0.176,
29,WD Parnell (SA),2010-2017,6,11,3,3,0,0,3,1 (1ct 0st),0.272,
30,CC Passailaigue (WI),1930-1930,1,2,3,3,0,0,3,2 (2ct 0st),1.5,
31,SR Patel (ENG),2012-2015,6,12,3,3,0,0,3,1 (1ct 0st),0.25,
32,AJ Pithey (SA),1957-1965,17,32,3,3,0,0,3,1 (1ct 0st),0.093,
33,LE Plunkett (ENG),2005-2014,13,25,3,3,0,0,3,1 (1ct 0st),0.12,
34,R Pollard (ENG),1946-1948,4,7,3,3,0,0,3,1 (1ct 0st),0.428,
35,RM Poore (SA),1896-1896,3,4,3,3,0,0,3,2 (2ct 0st),0.75,
36,SW Poynter (IRE),2019-2019,1,2,3,2,1,2,0,2 (1ct 1st),1.5,
37,C Pringle (NZ),1990-1995,14,24,3,3,0,0,3,1 (1ct 0st),0.125,
38,R Rampaul (WI),2009-2012,18,34,3,3,0,0,3,1 (1ct 0st),0.088,
39,BA Richards (SA),1970-1970,4,8,3,3,0,0,3,1 (1ct 0st),0.375,
40,F Ridgway (ENG),1951-1952,5,8,3,3,0,0,3,2 (2ct 0st),0.375,
41,WV Rodriguez (WI),1962-1968,5,10,3,3,0,0,3,2 (2ct 0st),0.3,
42,Sabbir Rahman (BAN),2016-2018,11,21,3,3,0,0,3,2 (2ct 0st),0.142,
43,Sajid Khan (PAK),2021-2021,4,8,3,3,0,0,3,1 (1ct 0st),0.375,
44,Salahuddin (PAK),1965-1969,5,9,3,3,0,0,3,1 (1ct 0st),0.333,
45,Saleem Altaf (PAK),1967-1978,21,41,3,3,0,0,3,1 (1ct 0st),0.073,
46,MAR Samarasekera (SL),1988-1991,4,6,3,3,0,0,3,2 (2ct 0st),0.5,
47,Shabbir Ahmed (PAK),2003-2005,10,19,3,3,0,0,3,1 (1ct 0st),0.157,
48,Shadab Khan (PAK),2017-2020,6,11,3,3,0,0,3,1 (1ct 0st),0.272,
49,WA Shalders (SA),1899-1907,12,23,3,3,0,0,3,1 (1ct 0st),0.13,
0,Shoriful Islam (BAN),2021-2022,3,5,3,3,0,0,3,1 (1ct 0st),0.6,
1,TAM Siriwardana (SL),2015-2016,5,10,3,3,0,0,3,1 (1ct 0st),0.3,
2,WN Slack (ENG),1986-1986,3,6,3,3,0,0,3,1 (1ct 0st),0.5,
3,JA Small (WI),1928-1930,3,4,3,3,0,0,3,2 (2ct 0st),0.75,
4,VI Smith (SA),1947-1957,9,16,3,3,0,0,3,1 (1ct 0st),0.187,
5,JT Sparling (NZ),1958-1964,11,16,3,3,0,0,3,1 (1ct 0st),0.187,
6,LA Stricker (SA),1910-1912,13,24,3,3,0,0,3,1 (1ct 0st),0.125,
7,Tahir Naqqash (PAK),1982-1985,15,27,3,3,0,0,3,1 (1ct 0st),0.111,
8,LJ Tancred (SA),1902-1913,14,26,3,3,0,0,3,1 (1ct 0st),0.115,
9,G Thomas (AUS),1965-1966,8,15,3,3,0,0,3,1 (1ct 0st),0.2,
10,NFD Thomson (AUS),1877-1877,2,4,3,3,0,0,3,2 (2ct 0st),0.75,
11,NI Thomson (ENG),1964-1965,5,10,3,3,0,0,3,1 (1ct 0st),0.3,
12,T Thushara (SL),2003-2010,10,18,3,3,0,0,3,2 (2ct 0st),0.166,
13,JW Trumble (AUS),1885-1886,7,11,3,3,0,0,3,2 (2ct 0st),0.272,
14,AJ Tudor (ENG),1998-2002,10,17,3,3,0,0,3,2 (2ct 0st),0.176,
15,EA van der Merwe (SA),1929-1936,2,3,3,3,0,3,0,2 (2ct 0st),1.0,
16,GH Vihari (INDIA),2018-2022,13,26,3,3,0,0,3,1 (1ct 0st),0.115,
17,R Vijay Bharadwaj (INDIA),1999-2000,3,5,3,3,0,0,3,2 (2ct 0st),0.6,
18,GE Vivian (NZ),1965-1972,5,10,3,3,0,0,3,1 (1ct 0st),0.3,
19,KA Walter (SA),1961-1961,2,4,3,3,0,0,3,1 (1ct 0st),0.75,
20,A Ward (ENG),1969-1976,5,9,3,3,0,0,3,2 (2ct 0st),0.333,
21,PF Warner (ENG),1899-1912,15,28,3,3,0,0,3,2 (2ct 0st),0.107,
22,DM Washington (WI),2005-2005,1,2,3,3,0,0,3,2 (2ct 0st),1.5,
23,GL Weir (NZ),1930-1937,11,16,3,3,0,0,3,1 (1ct 0st),0.187,
24,P Willey (ENG),1976-1986,26,44,3,3,0,0,3,1 (1ct 0st),0.068,
25,H Wood (ENG),1888-1892,4,8,3,2,1,2,0,2 (1ct 1st),0.375,
26,OE Wynne (SA),1948-1950,6,10,3,3,0,0,3,2 (2ct 0st),0.3,
27,V Yadav (INDIA),1993-1993,1,2,3,1,2,1,0,2 (0ct 2st),1.5,
28,Aamer Nazir (PAK),1993-1995,6,12,2,2,0,0,2,2 (2ct 0st),0.166,
29,Aaqib Javed (PAK),1989-1998,22,38,2,2,0,0,2,1 (1ct 0st),0.052,
30,Abdul Malik (1) (AFG),2021-2021,1,2,2,2,0,0,2,2 (2ct 0st),1.0,
31,Afaq Hussain (PAK),1961-1964,2,4,2,2,0,0,2,1 (1ct 0st),0.5,
32,G Alexander (AUS),1880-1884,2,4,2,2,0,0,2,1 (1ct 0st),0.5,
33,RC Allen (AUS),1887-1887,1,2,2,2,0,0,2,2 (2ct 0st),1.0,
34,GI Allott (NZ),1996-1999,10,16,2,2,0,0,2,1 (1ct 0st),0.125,
35,SW Ambris (WI),2017-2018,6,9,2,2,0,0,2,1 (1ct 0st),0.222,
36,Anamul Haque (BAN),2013-2014,4,7,2,2,0,0,2,1 (1ct 0st),0.285,
37,ML Apte (INDIA),1952-1953,7,12,2,2,0,0,2,1 (1ct 0st),0.166,
38,JC Archer (ENG),2019-2021,13,25,2,2,0,0,2,1 (1ct 0st),0.08,
39,Ariful Haque (BAN),2018-2018,2,4,2,2,0,0,2,1 (1ct 0st),0.5,
40,Arshad Ayub (INDIA),1987-1989,13,24,2,2,0,0,2,1 (1ct 0st),0.083,
41,B Arun (INDIA),1986-1987,2,3,2,2,0,0,2,1 (1ct 0st),0.666,
42,Asghar Afghan (AFG),2018-2021,6,11,2,2,0,0,2,1 (1ct 0st),0.181,
43,Ata-ur-Rehman (PAK),1992-1996,13,23,2,2,0,0,2,1 (1ct 0st),0.086,
44,ES Atkinson (WI),1958-1959,8,15,2,2,0,0,2,1 (1ct 0st),0.133,
45,RA Austin (WI),1978-1978,2,4,2,2,0,0,2,1 (1ct 0st),0.5,
46,S Badrinath (INDIA),2010-2010,2,3,2,2,0,0,2,1 (1ct 0st),0.666,
47,L Baichan (WI),1975-1976,3,6,2,2,0,0,2,2 (2ct 0st),0.333,
48,EAE Baptiste (WI),1983-1990,10,20,2,2,0,0,2,1 (1ct 0st),0.1,
49,F Barratt (ENG),1929-1930,5,8,2,2,0,0,2,1 (1ct 0st),0.25,
0,EL Bartlett (WI),1928-1931,5,7,2,2,0,0,2,1 (1ct 0st),0.285,
1,Bazid Khan (PAK),2005-2005,1,2,2,2,0,0,2,2 (2ct 0st),1.0,
2,DD Beard (NZ),1952-1956,4,7,2,2,0,0,2,2 (2ct 0st),0.285,
3,R Beaumont (SA),1912-1914,5,7,2,2,0,0,2,1 (1ct 0st),0.285,
4,DW Begbie (SA),1948-1950,5,8,2,2,0,0,2,1 (1ct 0st),0.25,
5,KCG Benjamin (WI),1992-1998,26,50,2,2,0,0,2,1 (1ct 0st),0.04,
6,R Berry (ENG),1950-1950,2,4,2,2,0,0,2,2 (2ct 0st),0.5,
7,MP Bicknell (ENG),1993-2003,4,7,2,2,0,0,2,1 (1ct 0st),0.285,
8,Bilal Asif (PAK),2018-2018,5,10,2,2,0,0,2,2 (2ct 0st),0.2,
9,JM Bird (AUS),2012-2017,9,17,2,2,0,0,2,1 (1ct 0st),0.117,
10,DD Blackie (AUS),1928-1929,3,6,2,2,0,0,2,2 (2ct 0st),0.333,
11,RJ Blakey (ENG),1993-1993,2,2,2,2,0,2,0,1 (1ct 0st),1.0,
12,DE Bollinger (AUS),2009-2010,12,23,2,2,0,0,2,1 (1ct 0st),0.086,
13,JB Bolus (ENG),1963-1964,7,14,2,2,0,0,2,1 (1ct 0st),0.142,
14,SG Borthwick (ENG),2014-2014,1,2,2,2,0,0,2,2 (2ct 0st),1.0,
15,WE Bowes (ENG),1932-1946,15,29,2,2,0,0,2,1 (1ct 0st),0.068,
16,EH Bowley (ENG),1929-1930,5,8,2,2,0,0,2,1 (1ct 0st),0.25,
17,NW Bracken (AUS),2003-2005,5,10,2,2,0,0,2,1 (1ct 0st),0.2,
18,WP Bradburn (NZ),1964-1964,2,4,2,2,0,0,2,1 (1ct 0st),0.5,
19,WH Brann (SA),1922-1923,3,6,2,2,0,0,2,1 (1ct 0st),0.333,
20,EH Bromley (AUS),1933-1934,2,3,2,2,0,0,2,1 (1ct 0st),0.666,
21,CP Buckenham (ENG),1910-1910,4,8,2,2,0,0,2,1 (1ct 0st),0.25,
22,FJ Burton (AUS),1887-1888,2,4,2,1,1,0,1,1 (1ct 0st),0.5,
23,TB Burtt (NZ),1947-1953,10,14,2,2,0,0,2,1 (1ct 0st),0.142,
24,HR Butt (ENG),1896-1896,3,6,2,1,1,1,0,1 (1ct 0st),0.333,
25,CG Butts (WI),1985-1988,7,12,2,2,0,0,2,1 (1ct 0st),0.166,
26,FJ Cameron (NZ),1961-1965,19,35,2,2,0,0,2,1 (1ct 0st),0.057,
27,J Cameron-Dow (IRE),2019-2019,1,2,2,2,0,0,2,2 (2ct 0st),1.0,
28,PH Carlson (AUS),1979-1979,2,4,2,2,0,0,2,1 (1ct 0st),0.5,
29,CP Carter (SA),1912-1924,10,16,2,2,0,0,2,1 (1ct 0st),0.125,
30,TW Cartwright (ENG),1964-1965,5,9,2,2,0,0,2,2 (2ct 0st),0.222,
31,B Casson (AUS),2008-2008,1,2,2,2,0,0,2,2 (2ct 0st),1.0,
32,R Chandrika (WI),2015-2016,5,7,2,2,0,0,2,2 (2ct 0st),0.285,
33,TM Chappell (AUS),1981-1981,3,6,2,2,0,0,2,1 (1ct 0st),0.333,
34,ST Clarke (WI),1978-1982,11,19,2,2,0,0,2,1 (1ct 0st),0.105,
35,SHM Colah (INDIA),1932-1933,2,4,2,2,0,0,2,2 (2ct 0st),0.5,
36,JB Commins (SA),1994-1995,3,6,2,2,0,0,2,1 (1ct 0st),0.333,
37,BB Cooper (AUS),1877-1877,1,2,2,2,0,0,2,2 (2ct 0st),1.0,
38,TA Copeland (AUS),2011-2011,3,6,2,2,0,0,2,1 (1ct 0st),0.333,
39,RMH Cottam (ENG),1969-1973,4,8,2,2,0,0,2,1 (1ct 0st),0.25,
40,ID Craig (AUS),1953-1958,11,20,2,2,0,0,2,1 (1ct 0st),0.1,
41,ML Cummins (WI),2016-2019,14,23,2,2,0,0,2,1 (1ct 0st),0.086,
42,WR Cuttell (ENG),1899-1899,2,4,2,2,0,0,2,2 (2ct 0st),0.5,
43,LA Dawson (ENG),2016-2017,3,5,2,2,0,0,2,2 (2ct 0st),0.4,
44,H Dean (ENG),1912-1912,3,5,2,2,0,0,2,1 (1ct 0st),0.4,
45,CS Dempster (NZ),1930-1933,10,15,2,2,0,0,2,1 (1ct 0st),0.133,
46,PWH de Silva (SL),2020-2021,4,7,2,2,0,0,2,1 (1ct 0st),0.285,
47,XJ Doherty (AUS),2010-2013,4,6,2,2,0,0,2,2 (2ct 0st),0.333,
48,H Donnan (AUS),1892-1896,5,9,2,2,0,0,2,1 (1ct 0st),0.222,
49,RR Dower (SA),1899-1899,1,2,2,2,0,0,2,1 (1ct 0st),1.0,
0,VC Drakes (WI),2002-2004,12,23,2,2,0,0,2,1 (1ct 0st),0.086,
1,JP Duminy (SA),1927-1929,3,6,2,2,0,0,2,1 (1ct 0st),0.333,
2,JA Dunning (NZ),1933-1937,4,7,2,2,0,0,2,1 (1ct 0st),0.285,
3,JH du Preez (SA),1967-1967,2,4,2,2,0,0,2,1 (1ct 0st),0.5,
4,CJ Eady (AUS),1896-1902,2,4,2,2,0,0,2,1 (1ct 0st),0.5,
5,Ehteshamuddin (PAK),1979-1982,5,8,2,2,0,0,2,1 (1ct 0st),0.25,
6,GD Elliott (NZ),2008-2009,5,9,2,2,0,0,2,2 (2ct 0st),0.222,
7,RM Ellison (ENG),1984-1986,11,22,2,2,0,0,2,1 (1ct 0st),0.09,
8,L Embuldeniya (SL),2019-2021,13,25,2,2,0,0,2,1 (1ct 0st),0.08,
9,SH Emery (AUS),1912-1912,4,5,2,2,0,0,2,1 (1ct 0st),0.4,
10,WS Farrer (SA),1962-1964,6,12,2,2,0,0,2,1 (1ct 0st),0.166,
11,Fazl-e-Akbar (PAK),1998-2004,5,8,2,2,0,0,2,1 (1ct 0st),0.25,
12,JP Fellows-Smith (SA),1960-1960,4,7,2,2,0,0,2,1 (1ct 0st),0.285,
13,CG Fichardt (SA),1892-1896,2,3,2,2,0,0,2,1 (1ct 0st),0.666,
14,W Flowers (ENG),1884-1893,8,15,2,2,0,0,2,1 (1ct 0st),0.133,
15,TJ Friend (ZIM),2001-2004,13,19,2,2,0,0,2,1 (1ct 0st),0.105,
16,LV Garrick (WI),2001-2001,1,2,2,2,0,0,2,1 (1ct 0st),1.0,
17,C Gladwin (ENG),1947-1949,8,15,2,2,0,0,2,1 (1ct 0st),0.133,
18,RA Gleeson (SA),1896-1896,1,2,2,2,0,0,2,1 (1ct 0st),1.0,
19,CD Gopinath (INDIA),1951-1960,8,14,2,2,0,0,2,1 (1ct 0st),0.142,
20,GF Grace (ENG),1880-1880,1,2,2,2,0,0,2,2 (2ct 0st),1.0,
21,R Graham (SA),1899-1899,2,4,2,2,0,0,2,2 (2ct 0st),0.5,
22,A Greenwood (ENG),1877-1877,2,4,2,2,0,0,2,1 (1ct 0st),0.5,
23,GM Guard (INDIA),1958-1960,2,4,2,2,0,0,2,2 (2ct 0st),0.5,
24,S Guha (INDIA),1967-1969,4,8,2,2,0,0,2,1 (1ct 0st),0.25,
25,DA Gunawardene (SL),1999-2005,6,9,2,2,0,0,2,1 (1ct 0st),0.222,
26,Gursharan Singh (INDIA),1990-1990,1,2,2,2,0,0,2,1 (1ct 0st),1.0,
27,JW Guy (NZ),1955-1961,12,15,2,2,0,0,2,1 (1ct 0st),0.133,
28,JR Hammond (AUS),1973-1973,5,10,2,2,0,0,2,2 (2ct 0st),0.2,
29,Lord Harris (ENG),1879-1884,4,7,2,2,0,0,2,1 (1ct 0st),0.285,
30,JC Hartley (ENG),1906-1906,2,3,2,2,0,0,2,1 (1ct 0st),0.666,
31,Hashmatullah Shahidi (AFG),2018-2021,5,9,2,2,0,0,2,1 (1ct 0st),0.222,
32,MJ Haslam (NZ),1992-1995,4,6,2,2,0,0,2,2 (2ct 0st),0.333,
33,EG Hayes (ENG),1906-1912,5,10,2,2,0,0,2,1 (1ct 0st),0.2,
34,RGA Headley (WI),1973-1973,2,4,2,2,0,0,2,1 (1ct 0st),0.5,
35,CW Henderson (SA),2001-2002,7,14,2,2,0,0,2,1 (1ct 0st),0.142,
36,O Henry (SA),1992-1993,3,5,2,2,0,0,2,2 (2ct 0st),0.4,
37,JC Hill (AUS),1953-1955,3,5,2,2,0,0,2,1 (1ct 0st),0.4,
38,DE Hoare (AUS),1961-1961,1,2,2,2,0,0,2,1 (1ct 0st),1.0,
39,TG Hogan (AUS),1983-1984,7,11,2,2,0,0,2,1 (1ct 0st),0.181,
40,WE Hollies (ENG),1935-1950,13,23,2,2,0,0,2,1 (1ct 0st),0.086,
41,BC Hollioake (ENG),1997-1998,2,4,2,2,0,0,2,1 (1ct 0st),0.5,
42,L Hone (ENG),1879-1879,1,2,2,2,0,2,0,2 (2ct 0st),1.0,
43,MJ Horton (ENG),1959-1959,2,4,2,2,0,0,2,1 (1ct 0st),0.5,
44,R Howorth (ENG),1947-1948,5,10,2,2,0,0,2,1 (1ct 0st),0.2,
45,A Hurwood (AUS),1930-1931,2,4,2,2,0,0,2,2 (2ct 0st),0.5,
46,RC Irani (ENG),1996-1999,3,5,2,2,0,0,2,2 (2ct 0st),0.4,
47,Irfan Fazil (PAK),2000-2000,1,2,2,2,0,0,2,1 (1ct 0st),1.0,
48,BL Irvine (SA),1970-1970,4,8,2,2,0,0,2,1 (1ct 0st),0.25,
49,JB Iverson (AUS),1950-1951,5,10,2,2,0,0,2,1 (1ct 0st),0.2,
0,SS Iyer (INDIA),2021-2021,2,4,2,2,0,0,2,2 (2ct 0st),0.5,
1,RJD Jamshedji (INDIA),1933-1933,1,2,2,2,0,0,2,2 (2ct 0st),1.0,
2,M Jansen (SA),2021-2022,3,6,2,2,0,0,2,1 (1ct 0st),0.333,
3,MP Jarvis (ZIM),1992-1994,5,8,2,2,0,0,2,1 (1ct 0st),0.25,
4,PW Jarvis (ENG),1988-1993,9,16,2,2,0,0,2,1 (1ct 0st),0.125,
5,MDUS Jayasundera (SL),2015-2015,2,4,2,2,0,0,2,1 (1ct 0st),0.5,
6,VB John (SL),1983-1984,6,9,2,2,0,0,2,1 (1ct 0st),0.222,
7,LJ Johnson (AUS),1948-1948,1,2,2,2,0,0,2,2 (2ct 0st),1.0,
8,Jubair Hossain (BAN),2014-2015,6,9,2,2,0,0,2,1 (1ct 0st),0.222,
9,H Jupp (ENG),1877-1877,2,4,2,2,0,0,2,2 (2ct 0st),0.5,
10,BR Jurangpathy (SL),1985-1986,2,3,2,2,0,0,2,2 (2ct 0st),0.666,
11,S Kalavitigoda (SL),2005-2005,1,1,2,2,0,0,2,2 (2ct 0st),2.0,
12,LWS Kaluperuma (SL),1982-1982,2,4,2,2,0,0,2,2 (2ct 0st),0.5,
13,M Kartik (INDIA),2000-2004,8,15,2,2,0,0,2,1 (1ct 0st),0.133,
14,TK Kendall (AUS),1877-1877,2,4,2,2,0,0,2,1 (1ct 0st),0.5,
15,RJ Kennedy (NZ),1996-1996,4,8,2,2,0,0,2,1 (1ct 0st),0.25,
16,Khaled Mahmud (BAN),2001-2003,12,17,2,2,0,0,2,1 (1ct 0st),0.117,
17,ET Killick (ENG),1929-1929,2,4,2,2,0,0,2,1 (1ct 0st),0.5,
18,LA King (WI),1962-1968,2,4,2,2,0,0,2,1 (1ct 0st),0.5,
19,RD King (WI),1999-2005,19,34,2,2,0,0,2,1 (1ct 0st),0.058,
20,RK Kleinveldt (SA),2012-2013,4,7,2,2,0,0,2,1 (1ct 0st),0.285,
21,P Kumar (INDIA),2011-2011,6,11,2,2,0,0,2,2 (2ct 0st),0.181,
22,VV Kumar (INDIA),1961-1961,2,4,2,2,0,0,2,1 (1ct 0st),0.5,
23,GA Lamb (ZIM),2011-2011,1,2,2,2,0,0,2,1 (1ct 0st),1.0,
24,CK Langeveldt (SA),2005-2006,6,11,2,2,0,0,2,1 (1ct 0st),0.181,
25,GB Lawrence (SA),1961-1962,5,10,2,2,0,0,2,2 (2ct 0st),0.2,
26,WS Lees (ENG),1906-1906,5,9,2,2,0,0,2,1 (1ct 0st),0.222,
27,IB Leggat (NZ),1954-1954,1,2,2,2,0,0,2,2 (2ct 0st),1.0,
28,PJ Loader (ENG),1954-1959,13,26,2,2,0,0,2,1 (1ct 0st),0.076,
29,Hon.A Lyttelton (ENG),1880-1884,4,7,2,2,0,2,0,1 (1ct 0st),0.285,
30,AB McDonald (AUS),2009-2009,4,7,2,2,0,0,2,1 (1ct 0st),0.285,
31,NC McGarrell (WI),2001-2001,4,8,2,2,0,0,2,1 (1ct 0st),0.25,
32,PG McShane (AUS),1885-1888,3,5,2,2,0,0,2,1 (1ct 0st),0.4,
33,NJ Maddinson (AUS),2016-2016,3,6,2,2,0,0,2,1 (1ct 0st),0.333,
34,IS Madray (WI),1958-1958,2,4,2,2,0,0,2,1 (1ct 0st),0.5,
35,JN Maguire (AUS),1983-1984,3,5,2,2,0,0,2,2 (2ct 0st),0.4,
36,AO Malhotra (INDIA),1982-1985,7,11,2,2,0,0,2,1 (1ct 0st),0.181,
37,AL Mann (AUS),1977-1978,4,7,2,2,0,0,2,1 (1ct 0st),0.285,
38,DA Marillier (ZIM),2000-2002,5,9,2,2,0,0,2,1 (1ct 0st),0.222,
39,Marshall Ayub (BAN),2013-2014,3,4,2,2,0,0,2,1 (1ct 0st),0.5,
40,F Martin (ENG),1890-1892,2,4,2,2,0,0,2,1 (1ct 0st),0.5,
41,FR Martin (WI),1928-1931,9,12,2,2,0,0,2,1 (1ct 0st),0.166,
42,SW Masakadza (ZIM),2012-2014,5,9,2,2,0,0,2,1 (1ct 0st),0.222,
43,AM Matheson (NZ),1930-1931,2,3,2,2,0,0,2,2 (2ct 0st),0.666,
44,ER Mayne (AUS),1912-1921,4,7,2,2,0,0,2,2 (2ct 0st),0.285,
45,M Mbangwa (ZIM),1996-2000,15,25,2,2,0,0,2,1 (1ct 0st),0.08,
46,JA McCollum (IRE),2019-2019,2,4,2,2,0,0,2,1 (1ct 0st),0.5,
47,Mehrab Hossain jnr (BAN),2007-2009,7,11,2,2,0,0,2,1 (1ct 0st),0.181,
48,BAW Mendis (SL),2008-2014,19,31,2,2,0,0,2,1 (1ct 0st),0.064,
49,WE Merritt (NZ),1930-1931,6,10,2,2,0,0,2,2 (2ct 0st),0.2,
0,AG Milkha Singh (INDIA),1960-1961,4,7,2,2,0,0,2,1 (1ct 0st),0.285,
1,WH Milton (SA),1889-1892,3,4,2,2,0,0,2,1 (1ct 0st),0.5,
2,F Mitchell (ENG/SA),1899-1912,5,8,2,2,0,0,2,1 (1ct 0st),0.25,
3,Mohammad Nabi (AFG),2018-2019,3,5,2,2,0,0,2,2 (2ct 0st),0.4,
4,Mohammad Nawaz (3) (PAK),2016-2016,3,6,2,2,0,0,2,1 (1ct 0st),0.333,
5,AM Moir (NZ),1951-1959,17,21,2,2,0,0,2,1 (1ct 0st),0.095,
6,Mosaddek Hossain (BAN),2017-2019,3,5,2,2,0,0,2,1 (1ct 0st),0.4,
7,SA Muller (AUS),1999-1999,2,4,2,2,0,0,2,1 (1ct 0st),0.5,
8,CT Mumba (ZIM),2016-2020,3,6,2,2,0,0,2,1 (1ct 0st),0.333,
9,N M'shangwe (ZIM),2014-2014,2,4,2,2,0,0,2,1 (1ct 0st),0.5,
10,S Muthusamy (SA),2019-2019,2,3,2,2,0,0,2,2 (2ct 0st),0.666,
11,Naeem Islam (BAN),2008-2012,8,15,2,2,0,0,2,1 (1ct 0st),0.133,
12,Nafees Iqbal (BAN),2004-2006,11,15,2,2,0,0,2,1 (1ct 0st),0.133,
13,MV Nagamootoo (WI),2000-2002,5,8,2,2,0,0,2,2 (2ct 0st),0.25,
14,R Nanan (WI),1980-1980,1,2,2,2,0,0,2,2 (2ct 0st),1.0,
15,SP Narine (WI),2012-2013,6,11,2,2,0,0,2,1 (1ct 0st),0.181,
16,Nasir Jamal (AFG),2019-2021,2,4,2,2,0,0,2,1 (1ct 0st),0.5,
17,A Ndlovu (ZIM),2020-2020,2,3,2,2,0,0,2,1 (1ct 0st),0.666,
18,RJ Nicol (NZ),2012-2012,2,4,2,2,0,0,2,1 (1ct 0st),0.5,
19,P Nissanka (SL),2021-2021,6,12,2,2,0,0,2,1 (1ct 0st),0.166,
20,M Nissar (INDIA),1932-1936,6,11,2,2,0,0,2,1 (1ct 0st),0.181,
21,JM Noreiga (WI),1971-1971,4,7,2,2,0,0,2,2 (2ct 0st),0.285,
22,RK Nunes (WI),1928-1930,4,5,2,2,0,1,1,1 (1ct 0st),0.4,
23,VM Nyauchi (ZIM),2020-2021,6,11,2,2,0,0,2,1 (1ct 0st),0.181,
24,J Nyumbu (ZIM),2014-2016,3,6,2,2,0,0,2,1 (1ct 0st),0.333,
25,NJ O'Brien (IRE),2018-2018,1,2,2,2,0,2,0,2 (2ct 0st),1.0,
26,J O'Connor (ENG),1929-1930,4,8,2,2,0,0,2,2 (2ct 0st),0.25,
27,D Olivier (SA),2017-2022,12,24,2,2,0,0,2,1 (1ct 0st),0.083,
28,DR O'Sullivan (NZ),1973-1976,11,19,2,2,0,0,2,1 (1ct 0st),0.105,
29,LCH Palairet (ENG),1902-1902,2,4,2,2,0,0,2,1 (1ct 0st),0.5,
30,Pankaj Singh (INDIA),2014-2014,2,3,2,2,0,0,2,1 (1ct 0st),0.666,
31,NM Parker (NZ),1976-1976,3,6,2,2,0,0,2,1 (1ct 0st),0.333,
32,LS Pascoe (AUS),1977-1982,14,27,2,2,0,0,2,1 (1ct 0st),0.074,
33,AR Patel (INDIA),2021-2021,5,10,2,2,0,0,2,1 (1ct 0st),0.2,
34,JM Patel (INDIA),1955-1960,7,11,2,2,0,0,2,1 (1ct 0st),0.181,
35,MM Patel (ENG),1996-1996,2,4,2,2,0,0,2,2 (2ct 0st),0.5,
36,Yuvraj of Patiala (INDIA),1934-1934,1,2,2,2,0,0,2,1 (1ct 0st),1.0,
37,KMA Paul (WI),2018-2019,3,5,2,2,0,0,2,1 (1ct 0st),0.4,
38,E Peate (ENG),1881-1886,9,15,2,2,0,0,2,1 (1ct 0st),0.133,
39,PDRL Perera (SL),1999-2002,8,14,2,2,0,0,2,1 (1ct 0st),0.142,
40,V Permaul (WI),2012-2021,7,13,2,2,0,0,2,1 (1ct 0st),0.153,
41,AL Phehlukwayo (SA),2017-2018,4,8,2,2,0,0,2,1 (1ct 0st),0.25,
42,WTS Porterfield (IRE),2018-2019,3,6,2,2,0,0,2,2 (2ct 0st),0.333,
43,JE Pothecary (SA),1960-1960,3,6,2,2,0,0,2,1 (1ct 0st),0.333,
44,AD Pougher (ENG),1892-1892,1,2,2,2,0,0,2,1 (1ct 0st),1.0,
45,AW Powell (SA),1899-1899,1,2,2,2,0,0,2,2 (2ct 0st),1.0,
46,D Pretorius (SA),2019-2020,3,6,2,2,0,0,2,1 (1ct 0st),0.333,
47,WFF Price (ENG),1938-1938,1,2,2,2,0,2,0,2 (2ct 0st),1.0,
48,HLE Promnitz (SA),1927-1928,2,4,2,2,0,0,2,1 (1ct 0st),0.5,
49,G Pullar (ENG),1959-1963,28,50,2,2,0,0,2,1 (1ct 0st),0.04,
0,PM Pushpakumara (SL),2017-2018,4,6,2,2,0,0,2,2 (2ct 0st),0.333,
1,AJ Pycroft (ZIM),1992-1992,3,5,2,2,0,0,2,1 (1ct 0st),0.4,
2,CG Rackemann (AUS),1982-1991,12,20,2,2,0,0,2,1 (1ct 0st),0.1,
3,RR Ramdass (WI),2005-2005,1,2,2,2,0,0,2,2 (2ct 0st),1.0,
4,S Ranatunga (SL),1994-1997,9,13,2,2,0,0,2,1 (1ct 0st),0.153,
5,Rashid Khan (PAK),1982-1985,4,7,2,2,0,0,2,1 (1ct 0st),0.285,
6,R Ravindra (NZ),2021-2022,3,6,2,2,0,0,2,2 (2ct 0st),0.333,
7,DA Renneberg (AUS),1966-1968,8,15,2,2,0,0,2,1 (1ct 0st),0.133,
8,JB Robertson (SA),1935-1936,3,5,2,2,0,0,2,1 (1ct 0st),0.4,
9,A Rose-Innes (SA),1889-1889,2,3,2,2,0,0,2,2 (2ct 0st),0.666,
10,TW Routledge (SA),1892-1896,4,5,2,2,0,0,2,1 (1ct 0st),0.4,
11,VPFA Royle (ENG),1879-1879,1,2,2,2,0,0,2,2 (2ct 0st),1.0,
12,Saleem Jaffar (PAK),1986-1992,14,26,2,2,0,0,2,1 (1ct 0st),0.076,
13,RO Scarlett (WI),1960-1960,3,6,2,2,0,0,2,1 (1ct 0st),0.333,
14,BN Schultz (SA),1992-1997,9,15,2,2,0,0,2,1 (1ct 0st),0.133,
15,CP Senanayake (SL),1991-1991,3,6,2,2,0,0,2,1 (1ct 0st),0.333,
16,MA Seymour (SA),1963-1970,7,12,2,2,0,0,2,1 (1ct 0st),0.166,
17,Shafiul Islam (BAN),2010-2017,11,21,2,2,0,0,2,1 (1ct 0st),0.095,
18,OA Shah (ENG),2006-2009,6,9,2,2,0,0,2,1 (1ct 0st),0.222,
19,Shaheen Shah Afridi (PAK),2018-2021,21,36,2,2,0,0,2,1 (1ct 0st),0.055,
20,Shahid Israr (PAK),1976-1976,1,2,2,2,0,2,0,2 (2ct 0st),1.0,
21,A Shahzad (ENG),2010-2010,1,2,2,2,0,0,2,1 (1ct 0st),1.0,
22,G Sharma (INDIA),1985-1990,5,9,2,2,0,0,2,1 (1ct 0st),0.222,
23,DA Sharpe (PAK),1959-1959,3,6,2,2,0,0,2,2 (2ct 0st),0.333,
24,JW Sharpe (ENG),1890-1892,3,6,2,2,0,0,2,1 (1ct 0st),0.333,
25,PP Shaw (INDIA),2018-2020,5,10,2,2,0,0,2,2 (2ct 0st),0.2,
26,BK Shepherd (AUS),1963-1965,9,18,2,2,0,0,2,1 (1ct 0st),0.111,
27,GH Shepstone (SA),1896-1899,2,3,2,2,0,0,2,2 (2ct 0st),0.666,
28,GC Shillingford (WI),1969-1972,7,12,2,2,0,0,2,2 (2ct 0st),0.166,
29,MJF Shrimpton (NZ),1963-1974,10,17,2,2,0,0,2,1 (1ct 0st),0.117,
30,ARS Silva (SL),2017-2019,12,23,2,2,0,0,2,1 (1ct 0st),0.086,
31,CEW Silverwood (ENG),1996-2002,6,9,2,2,0,0,2,1 (1ct 0st),0.222,
32,DJ Sincock (AUS),1964-1966,3,5,2,2,0,0,2,2 (2ct 0st),0.4,
33,CK Singh (WI),1960-1960,2,4,2,2,0,0,2,1 (1ct 0st),0.5,
34,VA Singh (WI),2017-2017,3,6,2,2,0,0,2,1 (1ct 0st),0.333,
35,CJE Smith (SA),1902-1902,3,6,2,2,0,0,2,2 (2ct 0st),0.333,
36,DR Smith (ENG),1961-1962,5,8,2,2,0,0,2,1 (1ct 0st),0.25,
37,FW Smith (SA),1889-1896,3,4,2,2,0,2,0,2 (2ct 0st),0.5,
38,SD Snooke (SA),1907-1907,1,2,2,2,0,0,2,2 (2ct 0st),1.0,
39,Sohail Khan (PAK),2009-2016,9,17,2,2,0,0,2,1 (1ct 0st),0.117,
40,Sohail Tanvir (PAK),2007-2007,2,4,2,2,0,0,2,1 (1ct 0st),0.5,
41,SW Sohoni (INDIA),1946-1951,4,6,2,2,0,0,2,1 (1ct 0st),0.333,
42,J Southerton (ENG),1877-1877,2,4,2,2,0,0,2,1 (1ct 0st),0.5,
43,GR Stead (NZ),1999-1999,5,9,2,2,0,0,2,1 (1ct 0st),0.222,
44,GB Stevens (AUS),1959-1960,4,8,2,2,0,0,2,1 (1ct 0st),0.25,
45,RB Stewart (SA),1889-1889,1,2,2,2,0,0,2,2 (2ct 0st),1.0,
46,CEL Stuart (WI),2000-2001,6,12,2,2,0,0,2,1 (1ct 0st),0.166,
47,Khaled Ahmed (BAN),2018-2021,3,4,2,2,0,0,2,1 (1ct 0st),0.5,
48,AB Tancred (SA),1889-1889,2,3,2,2,0,0,2,1 (1ct 0st),0.666,
49,FW Tate (ENG),1902-1902,1,2,2,2,0,0,2,1 (1ct 0st),1.0,
0,DD Taylor (NZ),1947-1956,3,5,2,2,0,0,2,1 (1ct 0st),0.4,
1,VP Terry (ENG),1984-1984,2,3,2,2,0,0,2,1 (1ct 0st),0.666,
2,SN Thakur (INDIA),2018-2022,7,14,2,2,0,0,2,1 (1ct 0st),0.142,
3,LF Townsend (ENG),1930-1934,4,8,2,2,0,0,2,1 (1ct 0st),0.25,
4,JC Tredwell (ENG),2010-2015,2,4,2,2,0,0,2,1 (1ct 0st),0.5,
5,J Trim (WI),1948-1952,4,8,2,2,0,0,2,1 (1ct 0st),0.25,
6,GB Troup (NZ),1976-1986,15,28,2,2,0,0,2,1 (1ct 0st),0.071,
7,LR Tuckett (SA),1914-1914,1,2,2,2,0,0,2,2 (2ct 0st),1.0,
8,GE Tyldesley (ENG),1921-1929,14,25,2,2,0,0,2,1 (1ct 0st),0.08,
9,ML Udawatte (SL),2018-2018,2,4,2,2,0,0,2,1 (1ct 0st),0.5,
10,P Utseya (ZIM),2004-2013,4,6,2,2,0,0,2,2 (2ct 0st),0.333,
11,BH Valentine (ENG),1933-1939,7,13,2,2,0,0,2,1 (1ct 0st),0.153,
12,BV Vitori (ZIM),2011-2013,4,7,2,2,0,0,2,1 (1ct 0st),0.285,
13,E Wainwright (ENG),1893-1898,5,8,2,2,0,0,2,1 (1ct 0st),0.25,
14,FH Walters (AUS),1885-1885,1,1,2,2,0,0,2,2 (2ct 0st),2.0,
15,B Warnapura (SL),1982-1982,4,7,2,2,0,0,2,1 (1ct 0st),0.285,
16,WJ Watson (AUS),1955-1955,4,7,2,2,0,0,2,1 (1ct 0st),0.285,
17,PN Webb (NZ),1980-1980,2,4,2,2,0,0,2,1 (1ct 0st),0.5,
18,AJ Webbe (ENG),1879-1879,1,2,2,2,0,0,2,2 (2ct 0st),1.0,
19,AW Wellard (ENG),1937-1938,2,4,2,2,0,0,2,2 (2ct 0st),0.5,
20,MD Wettimuny (SL),1983-1983,2,3,2,2,0,0,2,2 (2ct 0st),0.666,
21,MR Whitney (AUS),1981-1992,12,24,2,2,0,0,2,1 (1ct 0st),0.083,
22,EAV Williams (WI),1939-1948,4,8,2,2,0,0,2,1 (1ct 0st),0.25,
23,J Yadav (INDIA),2016-2021,5,10,2,2,0,0,2,1 (1ct 0st),0.2,
24,Zulqarnain Haider (PAK),2010-2010,1,2,2,2,0,2,0,2 (2ct 0st),1.0,
25,VR Aaron (INDIA),2011-2015,9,15,1,1,0,0,1,1 (1ct 0st),0.066,
26,Abdul Kadir (PAK),1964-1965,4,8,1,0,1,0,0,1 (0ct 1st),0.125,
27,Abu Jayed (BAN),2018-2021,13,19,1,1,0,0,1,1 (1ct 0st),0.052,
28,HD Ackerman (SA),1998-1998,4,8,1,1,0,0,1,1 (1ct 0st),0.125,
29,MR Adair (IRE),2019-2019,1,2,1,1,0,0,1,1 (1ct 0st),0.5,
30,AR Adams (NZ),2002-2002,1,2,1,1,0,0,1,1 (1ct 0st),0.5,
31,FS Ahangama (SL),1985-1985,3,6,1,1,0,0,1,1 (1ct 0st),0.166,
32,Aizaz Cheema (PAK),2011-2012,7,14,1,1,0,0,1,1 (1ct 0st),0.071,
33,Ali Naqvi (PAK),1997-1998,5,8,1,1,0,0,1,1 (1ct 0st),0.125,
34,IBA Allen (WI),1991-1991,2,3,1,1,0,0,1,1 (1ct 0st),0.333,
35,KN Amalean (SL),1986-1988,2,2,1,1,0,0,1,1 (1ct 0st),0.5,
36,Amir Hamza (AFG),2019-2021,3,6,1,1,0,0,1,1 (1ct 0st),0.166,
37,JH Anderson (SA),1902-1902,1,2,1,1,0,0,1,1 (1ct 0st),0.5,
38,RW Anderson (NZ),1976-1978,9,16,1,1,0,0,1,1 (1ct 0st),0.062,
39,WM Anderson (NZ),1946-1946,1,1,1,1,0,0,1,1 (1ct 0st),1.0,
40,KV Andrew (ENG),1954-1963,2,3,1,1,0,1,0,1 (1ct 0st),0.333,
41,B Andrews (NZ),1973-1974,2,3,1,1,0,0,1,1 (1ct 0st),0.333,
42,J Angel (AUS),1993-1995,4,7,1,1,0,0,1,1 (1ct 0st),0.142,
43,ZS Ansari (ENG),2016-2016,3,6,1,1,0,0,1,1 (1ct 0st),0.166,
44,KIC Asalanka (SL),2021-2021,1,2,1,1,0,0,1,1 (1ct 0st),0.5,
45,Azeem Hafeez (PAK),1983-1985,18,28,1,1,0,0,1,1 (1ct 0st),0.035,
46,FT Badcock (NZ),1930-1933,7,10,1,1,0,0,1,1 (1ct 0st),0.1,
47,SV Bahutule (INDIA),2001-2001,2,3,1,1,0,0,1,1 (1ct 0st),0.333,
48,LS Baker (WI),2008-2009,4,7,1,1,0,0,1,1 (1ct 0st),0.142,
49,L Balaji (INDIA),2003-2005,8,15,1,1,0,0,1,1 (1ct 0st),0.066,
0,JC Balderstone (ENG),1976-1976,2,4,1,1,0,0,1,1 (1ct 0st),0.25,
1,JT Ball (ENG),2016-2017,4,6,1,1,0,0,1,1 (1ct 0st),0.166,
2,RT Barber (NZ),1956-1956,1,2,1,1,0,0,1,1 (1ct 0st),0.5,
3,W Barber (ENG),1935-1935,2,4,1,1,0,0,1,1 (1ct 0st),0.25,
4,KJ Barnett (ENG),1988-1989,4,8,1,1,0,0,1,1 (1ct 0st),0.125,
5,JE Barrett (AUS),1890-1890,2,4,1,1,0,0,1,1 (1ct 0st),0.25,
6,HV Baumgartner (SA),1913-1913,1,1,1,1,0,0,1,1 (1ct 0st),1.0,
7,MA Beer (AUS),2011-2012,2,3,1,1,0,0,1,1 (1ct 0st),0.333,
8,W Bell (NZ),1954-1954,2,4,1,1,0,0,1,1 (1ct 0st),0.25,
9,P Bhandari (INDIA),1955-1956,3,6,1,1,0,0,1,1 (1ct 0st),0.166,
10,BA Bolton (NZ),1959-1959,2,2,1,1,0,0,1,1 (1ct 0st),0.5,
11,JT Botten (SA),1965-1965,3,6,1,1,0,0,1,1 (1ct 0st),0.166,
12,MP Bowden (ENG),1889-1889,2,4,1,1,0,1,0,1 (1ct 0st),0.25,
13,BP Bracewell (NZ),1978-1985,6,11,1,1,0,0,1,1 (1ct 0st),0.09,
14,DH Brain (ZIM),1992-1995,9,16,1,1,0,0,1,1 (1ct 0st),0.062,
15,GR Breese (WI),2002-2002,1,2,1,1,0,0,1,1 (1ct 0st),0.5,
16,DV Brennan (ENG),1951-1951,2,4,1,0,1,0,0,1 (0ct 1st),0.25,
17,GB Brent (ZIM),1999-2001,4,6,1,1,0,0,1,1 (1ct 0st),0.166,
18,AW Briscoe (SA),1935-1939,2,3,1,1,0,0,1,1 (1ct 0st),0.333,
19,HR Bromley-Davenport (ENG),1896-1899,4,8,1,1,0,0,1,1 (1ct 0st),0.125,
20,D Brookes (ENG),1948-1948,1,2,1,1,0,0,1,1 (1ct 0st),0.5,
21,A Brown (ENG),1961-1961,2,4,1,1,0,0,1,1 (1ct 0st),0.25,
22,SJE Brown (ENG),1996-1996,1,2,1,1,0,0,1,1 (1ct 0st),0.5,
23,CR Browne (WI),1928-1930,4,6,1,1,0,0,1,1 (1ct 0st),0.166,
24,CGD Burger (SA),1958-1958,2,4,1,1,0,0,1,1 (1ct 0st),0.25,
25,RP Burl (ZIM),2017-2021,3,5,1,1,0,0,1,1 (1ct 0st),0.2,
26,MG Burmester (ZIM),1992-1992,3,5,1,1,0,0,1,1 (1ct 0st),0.2,
27,IP Butchart (ZIM),1995-1995,1,2,1,1,0,0,1,1 (1ct 0st),0.5,
28,HJ Butler (ENG),1947-1948,2,4,1,1,0,0,1,1 (1ct 0st),0.25,
29,IW Callen (AUS),1978-1978,1,2,1,1,0,0,1,1 (1ct 0st),0.5,
30,GD Campbell (AUS),1989-1990,4,8,1,1,0,0,1,1 (1ct 0st),0.125,
31,GM Carew (WI),1935-1949,4,8,1,1,0,0,1,1 (1ct 0st),0.125,
32,HW Chapman (SA),1914-1921,2,4,1,1,0,0,1,1 (1ct 0st),0.25,
33,PP Chawla (INDIA),2006-2012,3,6,1,1,0,0,1,1 (1ct 0st),0.166,
34,GA Chevalier (SA),1970-1970,1,2,1,1,0,0,1,1 (1ct 0st),0.5,
35,JH Childs (ENG),1988-1988,2,3,1,1,0,0,1,1 (1ct 0st),0.333,
36,TS Chisoro (ZIM),2017-2021,3,3,1,1,0,0,1,1 (1ct 0st),0.333,
37,R Clarke (ENG),2003-2003,2,4,1,1,0,0,1,1 (1ct 0st),0.25,
38,JC Clay (ENG),1935-1935,1,2,1,1,0,0,1,1 (1ct 0st),0.5,
39,SK Coen (SA),1927-1928,2,4,1,1,0,0,1,1 (1ct 0st),0.25,
40,LJ Coldwell (ENG),1962-1964,7,14,1,1,0,0,1,1 (1ct 0st),0.071,
41,DJ Colley (AUS),1972-1972,3,6,1,1,0,0,1,1 (1ct 0st),0.166,
42,JMM Commaille (SA),1910-1928,12,19,1,1,0,0,1,1 (1ct 0st),0.052,
43,DP Conyngham (SA),1923-1923,1,2,1,1,0,0,1,1 (1ct 0st),0.5,
44,AHC Cooper (SA),1913-1913,1,1,1,1,0,0,1,1 (1ct 0st),1.0,
45,WH Cooper (AUS),1881-1884,2,4,1,1,0,0,1,1 (1ct 0st),0.25,
46,GA Cope (ENG),1977-1978,3,5,1,1,0,0,1,1 (1ct 0st),0.2,
47,WH Copson (ENG),1939-1947,3,6,1,1,0,0,1,1 (1ct 0st),0.166,
48,JT Cottam (AUS),1887-1887,1,2,1,1,0,0,1,1 (1ct 0st),0.5,
49,JL Cox (SA),1913-1914,3,4,1,1,0,0,1,1 (1ct 0st),0.25,
0,J Cranston (ENG),1890-1890,1,2,1,1,0,0,1,1 (1ct 0st),0.5,
1,WPA Crawford (AUS),1956-1956,4,8,1,1,0,0,1,1 (1ct 0st),0.125,
2,IB Cromb (NZ),1931-1932,5,7,1,1,0,0,1,1 (1ct 0st),0.142,
3,AC Cummins (WI),1993-1994,5,9,1,1,0,0,1,1 (1ct 0st),0.111,
4,RS Cunis (NZ),1964-1972,20,38,1,1,0,0,1,1 (1ct 0st),0.026,
5,KM Dabengwa (ZIM),2005-2005,3,4,1,1,0,0,1,1 (1ct 0st),0.25,
6,A Dananjaya (SL),2018-2019,6,12,1,1,0,0,1,1 (1ct 0st),0.083,
7,HT Dani (INDIA),1952-1952,1,2,1,1,0,0,1,1 (1ct 0st),0.5,
8,BA Davis (WI),1965-1965,4,7,1,1,0,0,1,1 (1ct 0st),0.142,
9,FI de Caires (WI),1930-1930,3,6,1,1,0,0,1,1 (1ct 0st),0.166,
10,M de Lange (SA),2011-2012,2,4,1,1,0,0,1,1 (1ct 0st),0.25,
11,EW Dempster (NZ),1953-1954,5,9,1,1,0,0,1,1 (1ct 0st),0.111,
12,SI de Saram (SL),1999-2000,4,8,1,1,0,0,1,1 (1ct 0st),0.125,
13,SKL de Silva (SL),1997-1997,3,4,1,1,0,1,0,1 (1ct 0st),0.25,
14,WRS de Silva (SL),2002-2007,3,6,1,1,0,0,1,1 (1ct 0st),0.166,
15,F de Wet (SA),2009-2010,2,4,1,1,0,0,1,1 (1ct 0st),0.25,
16,R Dhanraj (WI),1994-1996,4,8,1,1,0,0,1,1 (1ct 0st),0.125,
17,CD Dixon (SA),1914-1914,1,2,1,1,0,0,1,1 (1ct 0st),0.5,
18,HE Dollery (ENG),1947-1950,4,8,1,1,0,0,1,1 (1ct 0st),0.125,
19,A Dolphin (ENG),1921-1921,1,2,1,1,0,1,0,1 (1ct 0st),0.5,
20,A Ducat (ENG),1921-1921,1,2,1,1,0,0,1,1 (1ct 0st),0.5,
21,BM Duckett (ENG),2016-2016,4,8,1,1,0,0,1,1 (1ct 0st),0.125,
22,T Duffin (ZIM),2005-2005,2,3,1,1,0,0,1,1 (1ct 0st),0.333,
23,OR Dunell (SA),1889-1889,2,3,1,1,0,0,1,1 (1ct 0st),0.333,
24,JF du Toit (SA),1892-1892,1,1,1,1,0,0,1,1 (1ct 0st),1.0,
25,G Dymock (AUS),1974-1980,21,35,1,1,0,0,1,1 (1ct 0st),0.028,
26,Ebadot Hossain (BAN),2019-2022,12,16,1,1,0,0,1,1 (1ct 0st),0.062,
27,JD Edwards (AUS),1888-1888,3,4,1,1,0,0,1,1 (1ct 0st),0.25,
28,Elias Sunny (BAN),2011-2013,4,7,1,1,0,0,1,1 (1ct 0st),0.142,
29,S Elworthy (SA),1998-2002,4,8,1,1,0,0,1,1 (1ct 0st),0.125,
30,Enamul Haque (BAN),2001-2003,10,13,1,1,0,0,1,1 (1ct 0st),0.076,
31,CN Evans (ZIM),1996-2003,3,4,1,1,0,0,1,1 (1ct 0st),0.25,
32,GM Ewing (ZIM),2003-2005,3,5,1,1,0,0,1,1 (1ct 0st),0.2,
33,Fahim Muntasir (BAN),2002-2002,3,4,1,1,0,0,1,1 (1ct 0st),0.25,
34,K Farnes (ENG),1934-1939,15,27,1,1,0,0,1,1 (1ct 0st),0.037,
35,KHRK Fernando (SL),2002-2002,2,3,1,1,0,0,1,1 (1ct 0st),0.333,
36,LB Fishlock (ENG),1936-1947,4,7,1,1,0,0,1,1 (1ct 0st),0.142,
37,BC Francis (AUS),1972-1972,3,6,1,1,0,0,1,1 (1ct 0st),0.166,
38,HH Francis (SA),1899-1899,2,4,1,1,0,0,1,1 (1ct 0st),0.25,
39,JER Gallian (ENG),1995-1995,3,4,1,1,0,0,1,1 (1ct 0st),0.25,
40,A Gandotra (INDIA),1969-1969,2,4,1,1,0,0,1,1 (1ct 0st),0.25,
41,BBM Gaskin (WI),1948-1948,2,4,1,1,0,0,1,1 (1ct 0st),0.25,
42,RA Gaunt (AUS),1958-1964,3,5,1,1,0,0,1,1 (1ct 0st),0.2,
43,GL Gibbs (WI),1955-1955,1,2,1,1,0,0,1,1 (1ct 0st),0.5,
44,WF Giffen (AUS),1887-1892,3,5,1,1,0,0,1,1 (1ct 0st),0.2,
45,MR Gillespie (NZ),2007-2012,5,8,1,1,0,0,1,1 (1ct 0st),0.125,
46,H Gimblett (ENG),1936-1939,3,6,1,1,0,0,1,1 (1ct 0st),0.166,
47,N Gordon (SA),1938-1939,5,8,1,1,0,0,1,1 (1ct 0st),0.125,
48,AR Gover (ENG),1936-1946,4,7,1,1,0,0,1,1 (1ct 0st),0.142,
49,EM Grace (ENG),1880-1880,1,2,1,1,0,0,1,1 (1ct 0st),0.5,
0,T Greenhough (ENG),1959-1960,4,8,1,1,0,0,1,1 (1ct 0st),0.125,
1,EJ Gregory (AUS),1877-1877,1,2,1,1,0,0,1,1 (1ct 0st),0.5,
2,RG Gregory (AUS),1937-1937,2,4,1,1,0,0,1,1 (1ct 0st),0.25,
3,MG Grell (WI),1930-1930,1,2,1,1,0,0,1,1 (1ct 0st),0.5,
4,CG Halse (SA),1964-1964,3,6,1,1,0,0,1,1 (1ct 0st),0.166,
5,RA Hamence (AUS),1947-1948,3,6,1,1,0,0,1,1 (1ct 0st),0.166,
6,J Hardstaff snr (ENG),1907-1908,5,10,1,1,0,0,1,1 (1ct 0st),0.1,
7,SR Harmer (SA),2015-2015,5,8,1,1,0,0,1,1 (1ct 0st),0.125,
8,TA Harris (SA),1947-1949,3,6,1,1,0,0,1,1 (1ct 0st),0.166,
9,J Harry (AUS),1895-1895,1,2,1,1,0,0,1,1 (1ct 0st),0.5,
10,MJ Hartigan (AUS),1908-1908,2,4,1,1,0,0,1,1 (1ct 0st),0.25,
11,Haseeb Ahsan (PAK),1958-1962,12,20,1,1,0,0,1,1 (1ct 0st),0.05,
12,Hasibul Hossain (BAN),2000-2001,5,6,1,1,0,0,1,1 (1ct 0st),0.166,
13,JW Hastings (AUS),2012-2012,1,2,1,1,0,0,1,1 (1ct 0st),0.5,
14,A Hearne (ENG),1892-1892,1,2,1,1,0,0,1,1 (1ct 0st),0.5,
15,M Henderson (NZ),1930-1930,1,2,1,1,0,0,1,1 (1ct 0st),0.5,
16,MC Henriques (AUS),2013-2016,4,7,1,1,0,0,1,1 (1ct 0st),0.142,
17,PA Hibbert (AUS),1977-1977,1,2,1,1,0,0,1,1 (1ct 0st),0.5,
18,A Hill (ENG),1877-1877,2,4,1,1,0,0,1,1 (1ct 0st),0.25,
19,AJL Hill (ENG),1896-1896,3,6,1,1,0,0,1,1 (1ct 0st),0.166,
20,MJ Hilton (ENG),1950-1952,4,6,1,1,0,0,1,1 (1ct 0st),0.166,
21,ELG Hoad (WI),1928-1933,4,5,1,1,0,0,1,1 (1ct 0st),0.2,
22,GB Hogg (AUS),1996-2008,7,14,1,1,0,0,1,1 (1ct 0st),0.071,
23,JM Holland (AUS),2016-2018,4,8,1,1,0,0,1,1 (1ct 0st),0.125,
24,KW Hough (NZ),1959-1959,2,2,1,1,0,0,1,1 (1ct 0st),0.5,
25,WA Hunt (AUS),1932-1932,1,2,1,1,0,0,1,1 (1ct 0st),0.5,
26,LG Hylton (WI),1935-1939,6,12,1,1,0,0,1,1 (1ct 0st),0.083,
27,Iftikhar Ahmed (PAK),2016-2019,3,4,1,1,0,0,1,1 (1ct 0st),0.25,
28,AP Igglesden (ENG),1989-1994,3,5,1,1,0,0,1,1 (1ct 0st),0.2,
29,DEJ Ironside (SA),1953-1954,3,5,1,1,0,0,1,1 (1ct 0st),0.2,
30,Israr Ali (PAK),1952-1959,4,7,1,1,0,0,1,1 (1ct 0st),0.142,
31,SD Jack (SA),1994-1995,2,4,1,1,0,0,1,1 (1ct 0st),0.25,
32,HL Jackson (ENG),1949-1961,2,4,1,1,0,0,1,1 (1ct 0st),0.25,
33,Javed Ahmadi (AFG),2018-2021,3,5,1,1,0,0,1,1 (1ct 0st),0.2,
34,JNT Seales (WI),2021-2021,4,7,1,1,0,0,1,1 (1ct 0st),0.142,
35,CL Johnson (SA),1896-1896,1,1,1,1,0,0,1,1 (1ct 0st),1.0,
36,TF Johnson (WI),1939-1939,1,2,1,1,0,0,1,1 (1ct 0st),0.5,
37,EC Joyce (IRE),2018-2018,1,2,1,1,0,0,1,1 (1ct 0st),0.5,
38,Kabir Khan (PAK),1994-1995,4,7,1,1,0,0,1,1 (1ct 0st),0.142,
39,R Kaia (ZIM),2021-2021,3,4,1,1,0,0,1,1 (1ct 0st),0.25,
40,S Randiv (SL),2010-2012,12,21,1,1,0,0,1,1 (1ct 0st),0.047,
41,AR Kapoor (INDIA),1994-1996,4,7,1,1,0,0,1,1 (1ct 0st),0.142,
42,SS Karim (INDIA),2000-2000,1,2,1,1,0,1,0,1 (1ct 0st),0.5,
43,C Karunaratne (SL),2019-2019,1,2,1,1,0,0,1,1 (1ct 0st),0.5,
44,TJD Kelly (AUS),1877-1879,2,4,1,1,0,0,1,1 (1ct 0st),0.25,
45,RB Kenny (INDIA),1958-1960,5,8,1,1,0,0,1,1 (1ct 0st),0.125,
46,ESM Kentish (WI),1948-1954,2,4,1,1,0,0,1,1 (1ct 0st),0.25,
47,RB Kerr (AUS),1985-1985,2,4,1,1,0,0,1,1 (1ct 0st),0.25,
48,I Khan (SA),2009-2009,1,2,1,1,0,0,1,1 (1ct 0st),0.5,
49,G Kishenchand (INDIA),1947-1952,5,5,1,1,0,0,1,1 (1ct 0st),0.2,
0,AE Knight (ENG),1904-1904,3,6,1,1,0,0,1,1 (1ct 0st),0.166,
1,DJ Knight (ENG),1921-1921,2,4,1,1,0,0,1,1 (1ct 0st),0.25,
2,CM Kuggeleijn (NZ),1988-1988,2,4,1,1,0,0,1,1 (1ct 0st),0.25,
3,HG Kuhn (SA),2017-2017,4,8,1,1,0,0,1,1 (1ct 0st),0.125,
4,AP Kuiper (SA),1992-1992,1,2,1,1,0,0,1,1 (1ct 0st),0.5,
5,NM Kulkarni (INDIA),1997-2001,3,3,1,1,0,0,1,1 (1ct 0st),0.333,
6,RR Kulkarni (INDIA),1986-1987,3,6,1,1,0,0,1,1 (1ct 0st),0.166,
7,DSBP Kuruppu (SL),1987-1991,4,6,1,1,0,1,0,1 (1ct 0st),0.166,
8,MKGCP Lakshitha (SL),2002-2002,2,4,1,1,0,0,1,1 (1ct 0st),0.25,
9,Lall Singh (INDIA),1932-1932,1,2,1,1,0,0,1,1 (1ct 0st),0.5,
10,SG Law (AUS),1995-1995,1,2,1,1,0,0,1,1 (1ct 0st),0.5,
11,DW Lawrence (ENG),2021-2021,8,15,1,1,0,0,1,1 (1ct 0st),0.066,
12,PK Lee (AUS),1931-1933,2,4,1,1,0,0,1,1 (1ct 0st),0.25,
13,GB Legge (ENG),1927-1930,5,8,1,1,0,0,1,1 (1ct 0st),0.125,
14,CFH Leslie (ENG),1882-1883,4,8,1,1,0,0,1,1 (1ct 0st),0.125,
15,HDG Leveson Gower (ENG),1910-1910,3,6,1,1,0,0,1,1 (1ct 0st),0.166,
16,SH Lewis (WI),2018-2018,2,2,1,1,0,0,1,1 (1ct 0st),0.5,
17,Liaqat Ali (PAK),1975-1978,5,7,1,1,0,0,1,1 (1ct 0st),0.142,
18,GFJ Liebenberg (SA),1998-1998,5,10,1,1,0,0,1,1 (1ct 0st),0.1,
19,James Lillywhite jnr (ENG),1877-1877,2,4,1,1,0,0,1,1 (1ct 0st),0.25,
20,NV Lindsay (SA),1921-1921,1,2,1,1,0,0,1,1 (1ct 0st),0.5,
21,WVS Ling (SA),1921-1923,6,12,1,1,0,0,1,1 (1ct 0st),0.083,
22,AF Lissette (NZ),1956-1956,2,2,1,1,0,0,1,1 (1ct 0st),0.5,
23,KS Lokuarachchi (SL),2003-2004,4,7,1,1,0,0,1,1 (1ct 0st),0.142,
24,AP Lucas (ENG),1879-1884,5,9,1,1,0,0,1,1 (1ct 0st),0.111,
25,MJ McCague (ENG),1993-1994,3,5,1,1,0,0,1,1 (1ct 0st),0.2,
26,CP McGahey (ENG),1902-1902,2,4,1,1,0,0,1,1 (1ct 0st),0.25,
27,J McIlwraith (AUS),1886-1886,1,1,1,1,0,0,1,1 (1ct 0st),1.0,
28,CJ McKay (AUS),2009-2009,1,2,1,1,0,0,1,1 (1ct 0st),0.5,
29,AH McKinnon (SA),1960-1967,8,16,1,1,0,0,1,1 (1ct 0st),0.062,
30,W Madhevere (ZIM),2021-2021,2,4,1,1,0,0,1,1 (1ct 0st),0.25,
31,TN Madondo (ZIM),1998-2000,3,6,1,1,0,0,1,1 (1ct 0st),0.166,
32,NB Mahwire (ZIM),2002-2005,10,15,1,1,0,0,1,1 (1ct 0st),0.066,
33,A Maregwede (ZIM),2004-2004,2,2,1,1,0,0,1,1 (1ct 0st),0.5,
34,CS Marriott (ENG),1933-1933,1,2,1,1,0,0,1,1 (1ct 0st),0.5,
35,HJH Marshall (NZ),2000-2006,13,23,1,1,0,0,1,1 (1ct 0st),0.043,
36,RE Marshall (WI),1951-1952,4,8,1,1,0,0,1,1 (1ct 0st),0.125,
37,T Maruma (ZIM),2013-2021,4,7,1,1,0,0,1,1 (1ct 0st),0.142,
38,WP Masakadza (ZIM),2018-2018,1,2,1,1,0,0,1,1 (1ct 0st),0.5,
39,RAL Massie (AUS),1972-1973,6,12,1,1,0,0,1,1 (1ct 0st),0.083,
40,PS Masvaure (ZIM),2016-2021,8,13,1,1,0,0,1,1 (1ct 0st),0.076,
41,ADG Matthews (ENG),1937-1937,1,2,1,1,0,0,1,1 (1ct 0st),0.5,
42,CD Matthews (AUS),1986-1988,3,6,1,1,0,0,1,1 (1ct 0st),0.166,
43,W Mead (ENG),1899-1899,1,2,1,1,0,0,1,1 (1ct 0st),0.5,
44,KR Meherhomji (INDIA),1936-1936,1,1,1,1,0,1,0,1 (1ct 0st),1.0,
45,VL Mehra (INDIA),1955-1964,8,16,1,1,0,0,1,1 (1ct 0st),0.062,
46,RTM Mendis (SL),2021-2021,4,8,1,1,0,0,1,1 (1ct 0st),0.125,
47,CA Merry (WI),1933-1933,2,2,1,1,0,0,1,1 (1ct 0st),0.5,
48,KD Meuleman (AUS),1946-1946,1,2,1,1,0,0,1,1 (1ct 0st),0.5,
49,PL Mhambrey (INDIA),1996-1996,2,4,1,1,0,0,1,1 (1ct 0st),0.25,
0,J Middleton (SA),1896-1902,6,11,1,1,0,0,1,1 (1ct 0st),0.09,
1,LSM Miller (NZ),1953-1958,13,20,1,1,0,0,1,1 (1ct 0st),0.05,
2,FW Milligan (ENG),1899-1899,2,4,1,1,0,0,1,1 (1ct 0st),0.25,
3,CH Mills (SA),1892-1892,1,1,1,1,0,0,1,1 (1ct 0st),1.0,
4,JE Mills (NZ),1930-1933,7,10,1,1,0,0,1,1 (1ct 0st),0.1,
5,TB Mitchell (ENG),1933-1935,5,9,1,1,0,0,1,1 (1ct 0st),0.111,
6,Mohammad Ayub (PAK),2012-2012,1,2,1,1,0,0,1,1 (1ct 0st),0.5,
7,Mohammad Farooq (PAK),1960-1965,7,11,1,1,0,0,1,1 (1ct 0st),0.09,
8,Mohammad Hussain (PAK),1996-1998,2,3,1,1,0,0,1,1 (1ct 0st),0.333,
9,Mohammad Naim (BAN),2022-2022,1,1,1,1,0,0,1,1 (1ct 0st),1.0,
10,Mohammad Ramzan (PAK),1997-1997,1,1,1,1,0,0,1,1 (1ct 0st),1.0,
11,Mohammad Talha (PAK),2009-2014,4,6,1,1,0,0,1,1 (1ct 0st),0.166,
12,D Mohammed (WI),2004-2006,5,10,1,1,0,0,1,1 (1ct 0st),0.1,
13,AW Mold (ENG),1893-1893,3,5,1,1,0,0,1,1 (1ct 0st),0.2,
14,BD Morrison (NZ),1963-1963,1,1,1,1,0,0,1,1 (1ct 0st),1.0,
15,EA Moseley (WI),1990-1990,2,4,1,1,0,0,1,1 (1ct 0st),0.25,
16,H Moses (AUS),1887-1895,6,12,1,1,0,0,1,1 (1ct 0st),0.083,
17,AE Moss (ENG),1954-1960,9,17,1,1,0,0,1,1 (1ct 0st),0.058,
18,WH Moule (AUS),1880-1880,1,2,1,1,0,0,1,1 (1ct 0st),0.5,
19,Mufasir-ul-Haq (PAK),1965-1965,1,2,1,1,0,0,1,1 (1ct 0st),0.5,
20,Munir Malik (PAK),1959-1962,3,4,1,1,0,0,1,1 (1ct 0st),0.25,
21,Mustafizur Rahman (BAN),2015-2021,14,23,1,1,0,0,1,1 (1ct 0st),0.043,
22,CT Mutombodzi (ZIM),2020-2020,1,2,1,1,0,0,1,1 (1ct 0st),0.5,
23,S Nadeem (INDIA),2019-2021,2,4,1,1,0,0,1,1 (1ct 0st),0.25,
24,Naseem Shah (PAK),2019-2021,9,13,1,1,0,0,1,1 (1ct 0st),0.076,
25,Nasir Jamshed (PAK),2013-2013,2,4,1,1,0,0,1,1 (1ct 0st),0.25,
26,JG Navle (INDIA),1932-1933,2,4,1,1,0,1,0,1 (1ct 0st),0.25,
27,SV Nayak (INDIA),1982-1982,2,3,1,1,0,0,1,1 (1ct 0st),0.333,
28,Nazimuddin (BAN),2011-2012,3,5,1,1,0,0,1,1 (1ct 0st),0.2,
29,N Ncube (ZIM),2011-2011,1,2,1,1,0,0,1,1 (1ct 0st),0.5,
30,JD Nel (SA),1949-1957,6,10,1,1,0,0,1,1 (1ct 0st),0.1,
31,PJ Newport (ENG),1988-1991,3,6,1,1,0,0,1,1 (1ct 0st),0.166,
32,M Ngam (SA),2000-2001,3,5,1,1,0,0,1,1 (1ct 0st),0.2,
33,R Ngarava (ZIM),2021-2021,3,4,1,1,0,0,1,1 (1ct 0st),0.25,
34,Niaz Ahmed (PAK),1967-1969,2,4,1,1,0,0,1,1 (1ct 0st),0.25,
35,G Noblet (AUS),1950-1953,3,6,1,1,0,0,1,1 (1ct 0st),0.166,
36,AL Ochse (SA),1928-1929,3,6,1,1,0,0,1,1 (1ct 0st),0.166,
37,JL Ontong (SA),2002-2004,2,4,1,1,0,0,1,1 (1ct 0st),0.25,
38,GWF Overton (NZ),1953-1954,3,5,1,1,0,0,1,1 (1ct 0st),0.2,
39,AW Palm (SA),1927-1928,1,2,1,1,0,0,1,1 (1ct 0st),0.5,
40,BA Parchment (WI),2008-2008,2,3,1,1,0,0,1,1 (1ct 0st),0.333,
41,GAHM Parkar (INDIA),1982-1982,1,2,1,1,0,0,1,1 (1ct 0st),0.5,
42,DC Parkin (SA),1892-1892,1,1,1,1,0,0,1,1 (1ct 0st),1.0,
43,NT Pascal (WI),2010-2010,2,2,1,1,0,0,1,1 (1ct 0st),0.5,
44,RGM Patel (INDIA),1988-1988,1,2,1,1,0,0,1,1 (1ct 0st),0.5,
45,D Paterson (SA),2020-2020,2,3,1,1,0,0,1,1 (1ct 0st),0.333,
46,SR Patil (INDIA),1955-1955,1,2,1,1,0,0,1,1 (1ct 0st),0.5,
47,SG Peall (ZIM),1993-1994,4,7,1,1,0,0,1,1 (1ct 0st),0.142,
48,COC Pearse (SA),1910-1911,3,5,1,1,0,0,1,1 (1ct 0st),0.2,
49,ASA Perera (SL),1998-2001,3,6,1,1,0,0,1,1 (1ct 0st),0.166,
0,NLTC Perera (SL),2011-2012,6,9,1,1,0,0,1,1 (1ct 0st),0.111,
1,RTD Perks (ENG),1939-1939,2,3,1,1,0,0,1,1 (1ct 0st),0.333,
2,NO Perry (WI),1999-1999,4,7,1,1,0,0,1,1 (1ct 0st),0.142,
3,GD Phillips (NZ),2020-2020,1,2,1,1,0,0,1,1 (1ct 0st),0.5,
4,OJ Phillips (WI),2009-2009,2,4,1,1,0,0,1,1 (1ct 0st),0.25,
5,CJ Poole (ENG),1951-1952,3,5,1,1,0,0,1,1 (1ct 0st),0.2,
6,MB Poore (NZ),1953-1956,14,20,1,1,0,0,1,1 (1ct 0st),0.05,
7,RL Powell (WI),1999-2004,2,4,1,1,0,0,1,1 (1ct 0st),0.25,
8,N Puna (NZ),1966-1966,3,5,1,1,0,0,1,1 (1ct 0st),0.2,
9,NA Quinn (SA),1929-1932,12,19,1,1,0,0,1,1 (1ct 0st),0.052,
10,LS Rajput (INDIA),1985-1985,2,4,1,1,0,0,1,1 (1ct 0st),0.25,
11,L Ramji (INDIA),1933-1933,1,2,1,1,0,0,1,1 (1ct 0st),0.5,
12,KM Rangnekar (INDIA),1947-1948,3,4,1,1,0,0,1,1 (1ct 0st),0.25,
13,VB Ranjane (INDIA),1958-1964,7,14,1,1,0,0,1,1 (1ct 0st),0.071,
14,Ranjan Das (BAN),2000-2000,1,2,1,1,0,0,1,1 (1ct 0st),0.5,
15,JR Ratnayeke (SL),1982-1989,22,32,1,1,0,0,1,1 (1ct 0st),0.031,
16,JC Reedman (AUS),1894-1894,1,2,1,1,0,0,1,1 (1ct 0st),0.5,
17,DA Reeve (ENG),1992-1992,3,6,1,1,0,0,1,1 (1ct 0st),0.166,
18,MR Rege (INDIA),1949-1949,1,1,1,1,0,0,1,1 (1ct 0st),1.0,
19,SF Rehman (PAK),1958-1958,1,2,1,1,0,0,1,1 (1ct 0st),0.5,
20,JA Rennie (ZIM),1993-1997,4,8,1,1,0,0,1,1 (1ct 0st),0.125,
21,AJ Richardson (AUS),1924-1926,9,14,1,1,0,0,1,1 (1ct 0st),0.071,
22,DW Richardson (ENG),1957-1957,1,2,1,1,0,0,1,1 (1ct 0st),0.5,
23,GR Robertson (AUS),1998-1998,4,7,1,1,0,0,1,1 (1ct 0st),0.142,
24,RH Robinson (AUS),1936-1936,1,2,1,1,0,0,1,1 (1ct 0st),0.5,
25,BG Rogers (ZIM),2005-2005,4,6,1,1,0,0,1,1 (1ct 0st),0.166,
26,CF Root (ENG),1926-1926,3,3,1,1,0,0,1,1 (1ct 0st),0.333,
27,GF Rorke (AUS),1959-1959,4,8,1,1,0,0,1,1 (1ct 0st),0.125,
28,CG Rowe (NZ),1946-1946,1,1,1,1,0,0,1,1 (1ct 0st),1.0,
29,JJ Roy (ENG),2019-2019,5,10,1,1,0,0,1,1 (1ct 0st),0.1,
30,P Roy (INDIA),1982-1982,2,2,1,1,0,0,1,1 (1ct 0st),0.5,
31,AD Russell (WI),2010-2010,1,2,1,1,0,0,1,1 (1ct 0st),0.5,
32,MJ Saggers (ENG),2003-2004,3,6,1,1,0,0,1,1 (1ct 0st),0.166,
33,NA Saini (INDIA),2021-2021,2,4,1,1,0,0,1,1 (1ct 0st),0.25,
34,SV Samuelson (SA),1910-1910,1,2,1,1,0,0,1,1 (1ct 0st),0.5,
35,BS Sandhu (INDIA),1983-1983,8,11,1,1,0,0,1,1 (1ct 0st),0.09,
36,Sanwar Hossain (BAN),2001-2003,9,11,1,1,0,0,1,1 (1ct 0st),0.09,
37,Sarandeep Singh (INDIA),2000-2002,3,5,1,1,0,0,1,1 (1ct 0st),0.2,
38,CJ Sayers (AUS),2018-2018,1,2,1,1,0,0,1,1 (1ct 0st),0.5,
39,AW Seccull (SA),1896-1896,1,1,1,1,0,0,1,1 (1ct 0st),1.0,
40,J Selby (ENG),1877-1882,6,11,1,1,0,1,0,1 (1ct 0st),0.09,
41,RHD Sellers (AUS),1964-1964,1,1,1,1,0,0,1,1 (1ct 0st),1.0,
42,MWW Selvey (ENG),1976-1977,3,6,1,1,0,0,1,1 (1ct 0st),0.166,
43,SMSM Senanayake (SL),2013-2014,1,2,1,1,0,0,1,1 (1ct 0st),0.5,
44,D Shackleton (ENG),1950-1963,7,13,1,1,0,0,1,1 (1ct 0st),0.076,
45,Shahriar Hossain (BAN),2000-2004,3,5,1,0,1,0,0,1 (0ct 1st),0.2,
46,Shakeel Ahmed snr (PAK),1998-1998,1,2,1,1,0,0,1,1 (1ct 0st),0.5,
47,AK Sharma (INDIA),1988-1988,1,2,1,1,0,0,1,1 (1ct 0st),0.5,
48,PH Sharma (INDIA),1974-1977,5,7,1,1,0,0,1,1 (1ct 0st),0.142,
49,SK Sharma (INDIA),1988-1990,2,4,1,1,0,0,1,1 (1ct 0st),0.25,
0,J Sharp (ENG),1909-1909,3,6,1,1,0,0,1,1 (1ct 0st),0.166,
1,IT Shillingford (WI),1977-1978,4,8,1,1,0,0,1,1 (1ct 0st),0.125,
2,RH Shodhan (INDIA),1952-1953,3,6,1,1,0,0,1,1 (1ct 0st),0.166,
3,M Shumba (ZIM),2021-2021,3,4,1,1,0,0,1,1 (1ct 0st),0.25,
4,K Shuttleworth (ENG),1970-1971,5,9,1,1,0,0,1,1 (1ct 0st),0.111,
5,IR Siddiqui (INDIA),2001-2001,1,2,1,1,0,0,1,1 (1ct 0st),0.5,
6,KJ Silva (SL),1995-1998,7,12,1,1,0,0,1,1 (1ct 0st),0.083,
7,GHT Simpson-Hayward (ENG),1910-1910,5,10,1,1,0,0,1,1 (1ct 0st),0.1,
8,IM Sinclair (NZ),1956-1956,2,3,1,1,0,0,1,1 (1ct 0st),0.333,
9,R Singh (INDIA),1999-1999,1,2,1,1,0,0,1,1 (1ct 0st),0.5,
10,VRV Singh (INDIA),2006-2007,5,10,1,1,0,0,1,1 (1ct 0st),0.1,
11,L Sipamla (SA),2020-2021,2,4,1,1,0,0,1,1 (1ct 0st),0.25,
12,CIJ Smith (ENG),1935-1937,5,9,1,1,0,0,1,1 (1ct 0st),0.111,
13,D Smith (ENG),1935-1935,2,4,1,1,0,0,1,1 (1ct 0st),0.25,
14,FB Smith (NZ),1947-1952,4,7,1,1,0,0,1,1 (1ct 0st),0.142,
15,H Smith (ENG),1928-1928,1,2,1,1,0,1,0,1 (1ct 0st),0.5,
16,SB Smith (AUS),1984-1984,3,6,1,1,0,0,1,1 (1ct 0st),0.166,
17,TPB Smith (ENG),1946-1947,4,5,1,1,0,0,1,1 (1ct 0st),0.2,
18,RP Snell (SA),1992-1994,5,9,1,1,0,0,1,1 (1ct 0st),0.111,
19,WRT Solomon (SA),1899-1899,1,2,1,1,0,0,1,1 (1ct 0st),0.5,
20,WH St Hill (WI),1928-1930,3,4,1,1,0,0,1,1 (1ct 0st),0.25,
21,DA Stirling (NZ),1984-1986,6,11,1,1,0,0,1,1 (1ct 0st),0.09,
22,OP Stone (ENG),2019-2021,3,6,1,1,0,0,1,1 (1ct 0st),0.166,
23,MD Stoneman (ENG),2017-2018,11,19,1,1,0,0,1,1 (1ct 0st),0.052,
24,GB Street (ENG),1923-1923,1,1,1,0,1,0,0,1 (0ct 1st),1.0,
25,PC Strydom (SA),2000-2000,2,4,1,1,0,0,1,1 (1ct 0st),0.25,
26,MJ Susskind (SA),1924-1924,5,5,1,1,0,0,1,1 (1ct 0st),0.2,
27,SW Tait (AUS),2005-2008,3,6,1,1,0,0,1,1 (1ct 0st),0.166,
28,Talha Jubair (BAN),2002-2004,7,9,1,1,0,0,1,1 (1ct 0st),0.111,
29,Tanvir Ahmed (PAK),2010-2013,5,10,1,1,0,0,1,1 (1ct 0st),0.1,
30,GL Tapscott (SA),1913-1913,1,1,1,1,0,0,1,1 (1ct 0st),1.0,
31,Tareq Aziz (BAN),2004-2004,3,4,1,1,0,0,1,1 (1ct 0st),0.25,
32,Taskin Ahmed (BAN),2017-2022,10,18,1,1,0,0,1,1 (1ct 0st),0.055,
33,K Taylor (ENG),1959-1964,3,6,1,1,0,0,1,1 (1ct 0st),0.166,
34,LB Taylor (ENG),1985-1985,2,4,1,1,0,0,1,1 (1ct 0st),0.25,
35,G Thornton (SA),1902-1902,1,2,1,1,0,0,1,1 (1ct 0st),0.5,
36,DCH Townsend (ENG),1935-1935,3,5,1,1,0,0,1,1 (1ct 0st),0.2,
37,JPF Travers (AUS),1902-1902,1,2,1,1,0,0,1,1 (1ct 0st),0.5,
38,PB Truscott (NZ),1965-1965,1,2,1,1,0,0,1,1 (1ct 0st),0.5,
39,LL Tsotsobe (SA),2010-2011,5,9,1,1,0,0,1,1 (1ct 0st),0.111,
40,NC Tufnell (ENG),1910-1910,1,2,1,0,1,0,0,1 (0ct 1st),0.5,
41,MJL Turnbull (ENG),1930-1936,9,17,1,1,0,0,1,1 (1ct 0st),0.058,
42,Tushar Imran (BAN),2002-2007,5,6,1,1,0,0,1,1 (1ct 0st),0.166,
43,RK Tyldesley (ENG),1924-1930,7,11,1,1,0,0,1,1 (1ct 0st),0.09,
44,SD Udal (ENG),2005-2006,4,7,1,1,0,0,1,1 (1ct 0st),0.142,
45,Umar Amin (PAK),2010-2010,4,8,1,1,0,0,1,1 (1ct 0st),0.125,
46,PGV van der Bijl (SA),1938-1939,5,8,1,1,0,0,1,1 (1ct 0st),0.125,
47,M Venkataramana (INDIA),1989-1989,1,2,1,1,0,0,1,1 (1ct 0st),0.5,
48,DP Viljoen (ZIM),1998-2000,2,3,1,1,0,0,1,1 (1ct 0st),0.333,
49,CH Vintcent (SA),1889-1892,3,4,1,1,0,0,1,1 (1ct 0st),0.25,
0,Vizianagram (INDIA),1936-1936,3,5,1,1,0,0,1,1 (1ct 0st),0.2,
1,A Waddington (ENG),1920-1921,2,4,1,1,0,0,1,1 (1ct 0st),0.25,
2,MG Waite (AUS),1938-1938,2,3,1,1,0,0,1,1 (1ct 0st),0.333,
3,AC Waller (ZIM),1996-1996,2,4,1,1,0,0,1,1 (1ct 0st),0.25,
4,A Ward (ENG),1893-1895,7,13,1,1,0,0,1,1 (1ct 0st),0.076,
5,FA Ward (AUS),1936-1938,4,6,1,1,0,0,1,1 (1ct 0st),0.166,
6,IJ Ward (ENG),2001-2001,5,9,1,1,0,0,1,1 (1ct 0st),0.111,
7,A Warren (ENG),1905-1905,1,2,1,1,0,0,1,1 (1ct 0st),0.5,
8,Washington Sundar (INDIA),2021-2021,4,8,1,1,0,0,1,1 (1ct 0st),0.125,
9,AS Wassan (INDIA),1990-1990,4,7,1,1,0,0,1,1 (1ct 0st),0.142,
10,SL Watkin (ENG),1991-1993,3,6,1,1,0,0,1,1 (1ct 0st),0.166,
11,JR Watkins (AUS),1973-1973,1,2,1,1,0,0,1,1 (1ct 0st),0.5,
12,M Watkinson (ENG),1995-1996,4,7,1,1,0,0,1,1 (1ct 0st),0.142,
13,CD Watson (WI),1960-1962,7,14,1,1,0,0,1,1 (1ct 0st),0.071,
14,GD Watson (AUS),1966-1972,5,9,1,1,0,0,1,1 (1ct 0st),0.111,
15,S Wazir Ali (INDIA),1932-1936,7,13,1,1,0,0,1,1 (1ct 0st),0.076,
16,C Wesley (SA),1960-1960,3,5,1,1,0,0,1,1 (1ct 0st),0.2,
17,T Westley (ENG),2017-2017,5,10,1,1,0,0,1,1 (1ct 0st),0.1,
18,JJ Whitaker (ENG),1986-1986,1,2,1,1,0,0,1,1 (1ct 0st),0.5,
19,AW White (WI),1965-1965,2,3,1,1,0,0,1,1 (1ct 0st),0.333,
20,CL White (AUS),2008-2008,4,8,1,1,0,0,1,1 (1ct 0st),0.125,
21,RGCE Wijesuriya (SL),1982-1985,4,6,1,1,0,0,1,1 (1ct 0st),0.166,
22,D Wilson (ENG),1964-1971,6,12,1,1,0,0,1,1 (1ct 0st),0.083,
23,PL Winslow (SA),1950-1955,5,8,1,1,0,0,1,1 (1ct 0st),0.125,
24,AJ Woodcock (AUS),1974-1974,1,2,1,1,0,0,1,1 (1ct 0st),0.5,
25,Yasir Ali (BAN),2021-2022,3,5,1,1,0,0,1,1 (1ct 0st),0.2,
26,T Yohannan (INDIA),2001-2002,3,6,1,1,0,0,1,1 (1ct 0st),0.166,
27,HI Young (ENG),1899-1899,2,4,1,1,0,0,1,1 (1ct 0st),0.25,
28,Zahoor Elahi (PAK),1996-1996,2,4,1,1,0,0,1,1 (1ct 0st),0.25,
29,Zakir Khan (PAK),1986-1989,2,4,1,1,0,0,1,1 (1ct 0st),0.25,
30,M Zondeki (SA),2003-2008,6,11,1,1,0,0,1,1 (1ct 0st),0.09,
31,Abdul Wasi (AFG),2021-2021,1,2,0,0,0,0,0,0,0.0,
32,Abdur Rauf (PAK),2009-2009,3,6,0,0,0,0,0,0,0.0,
33,CA Absolom (ENG),1879-1879,1,2,0,0,0,0,0,0,0.0,
34,Aftab Baloch (PAK),1969-1975,2,4,0,0,0,0,0,0,0.0,
35,U Afzaal (ENG),2001-2001,3,4,0,0,0,0,0,0,0.0,
36,AC Agar (AUS),2013-2017,4,8,0,0,0,0,0,0,0.0,
37,Agha Zahid (PAK),1975-1975,1,2,0,0,0,0,0,0,0.0,
38,JP Agnew (ENG),1984-1985,3,6,0,0,0,0,0,0,0.0,
39,Alamgir Kabir (BAN),2002-2004,3,4,0,0,0,0,0,0,0.0,
40,HH Alexander (AUS),1933-1933,1,2,0,0,0,0,0,0,0.0,
41,Imtiaz Ali (WI),1976-1976,1,2,0,0,0,0,0,0,0.0,
42,Kabir Ali (ENG),2003-2003,1,2,0,0,0,0,0,0,0.0,
43,Ali Hussain Rizvi (PAK),1997-1997,1,1,0,0,0,0,0,0,0.0,
44,FE Allan (AUS),1879-1879,1,2,0,0,0,0,0,0,0.0,
45,PJ Allan (AUS),1965-1965,1,2,0,0,0,0,0,0,0.0,
46,MJC Allom (ENG),1930-1931,5,8,0,0,0,0,0,0,0.0,
47,Al-Amin Hossain (BAN),2013-2019,7,11,0,0,0,0,0,0,0.0,
48,MKDI Amerasinghe (SL),2008-2008,1,2,0,0,0,0,0,0,0.0,
49,Amir Elahi (INDIA/PAK),1947-1952,6,9,0,0,0,0,0,0,0.0,
0,SA Ankola (INDIA),1989-1989,1,2,0,0,0,0,0,0,0.0,
1,Anwar Hossain Monir (BAN),2003-2005,3,3,0,0,0,0,0,0,0.0,
2,Anwar Hossain (BAN),2002-2002,1,1,0,0,0,0,0,0,0.0,
3,Anwar Hussain (PAK),1952-1952,4,6,0,0,0,0,0,0,0.0,
4,Anwar Khan (PAK),1979-1979,1,2,0,0,0,0,0,0,0.0,
5,AL Apte (INDIA),1959-1959,1,1,0,0,0,0,0,0,0.0,
6,AG Archer (ENG),1899-1899,1,2,0,0,0,0,0,0,0.0,
7,KA Archer (AUS),1950-1951,5,10,0,0,0,0,0,0,0.0,
8,Arif Butt (PAK),1964-1965,3,6,0,0,0,0,0,0,0.0,
9,T Armitage (ENG),1877-1877,2,4,0,0,0,0,0,0,0.0,
10,J Arnold (ENG),1931-1931,1,2,0,0,0,0,0,0,0.0,
11,Arshad Khan (PAK),1997-2005,9,17,0,0,0,0,0,0,0.0,
12,NS Asgarali (WI),1957-1957,2,2,0,0,0,0,0,0,0.0,
13,Ashfaq Ahmed (PAK),1993-1993,1,2,0,0,0,0,0,0,0.0,
14,WH Ashley (SA),1889-1889,1,1,0,0,0,0,0,0,0.0,
15,Atif Rauf (PAK),1994-1994,1,2,0,0,0,0,0,0,0.0,
16,Azam Khan (PAK),1996-1996,1,2,0,0,0,0,0,0,0.0,
17,Azhar Khan (PAK),1980-1980,1,2,0,0,0,0,0,0,0.0,
18,Azmat Rana (PAK),1980-1980,1,2,0,0,0,0,0,0,0.0,
19,RJ Bailey (ENG),1988-1990,4,7,0,0,0,0,0,0,0.0,
20,MRCN Bandaratilleke (SL),1998-2001,7,14,0,0,0,0,0,0,0.0,
21,SN Banerjee (INDIA),1949-1949,1,2,0,0,0,0,0,0,0.0,
22,ST Banerjee (INDIA),1992-1992,1,2,0,0,0,0,0,0,0.0,
23,C Bannerman (AUS),1877-1879,3,6,0,0,0,0,0,0,0.0,
24,M Baqa Jilani (INDIA),1936-1936,1,2,0,0,0,0,0,0,0.0,
25,GD Barlow (ENG),1976-1977,3,6,0,0,0,0,0,0,0.0,
26,AG Barrett (WI),1971-1975,6,10,0,0,0,0,0,0,0.0,
27,VA Barton (ENG),1892-1892,1,2,0,0,0,0,0,0,0.0,
28,GR Beard (AUS),1980-1980,3,4,0,0,0,0,0,0,0.0,
29,JEF Beck (NZ),1953-1956,8,14,0,0,0,0,0,0,0.0,
30,J Benaud (AUS),1972-1973,3,6,0,0,0,0,0,0,0.0,
31,JE Benjamin (ENG),1994-1994,1,2,0,0,0,0,0,0,0.0,
32,HK Bennett (NZ),2010-2010,1,2,0,0,0,0,0,0,0.0,
33,MR Benson (ENG),1986-1986,1,2,0,0,0,0,0,0,0.0,
34,DE Bernard (WI),2003-2009,3,6,0,0,0,0,0,0,0.0,
35,BJ Bess (WI),2010-2010,1,2,0,0,0,0,0,0,0.0,
36,N Betancourt (WI),1930-1930,1,2,0,0,0,0,0,0,0.0,
37,M Bhanuka (SL),2021-2021,1,2,0,0,0,0,0,0,0.0,
38,AR Bhat (INDIA),1983-1983,2,3,0,0,0,0,0,0,0.0,
39,Bilawal Bhatti (PAK),2013-2014,2,4,0,0,0,0,0,0,0.0,
40,GF Bissett (SA),1927-1928,4,8,0,0,0,0,0,0,0.0,
41,MI Black (WI),2000-2002,6,10,0,0,0,0,0,0,0.0,
42,ID Blackwell (ENG),2006-2006,1,2,0,0,0,0,0,0,0.0,
43,EG Bock (SA),1935-1935,1,2,0,0,0,0,0,0,0.0,
44,GE Bond (SA),1938-1938,1,2,0,0,0,0,0,0,0.0,
45,MW Booth (ENG),1913-1914,2,4,0,0,0,0,0,0,0.0,
46,T Bosch (SA),1992-1992,1,2,0,0,0,0,0,0,0.0,
47,WM Bradley (ENG),1899-1899,2,4,0,0,0,0,0,0,0.0,
48,CR Brathwaite (WI),2015-2016,3,4,0,0,0,0,0,0,0.0,
49,W Brearley (ENG),1905-1912,4,8,0,0,0,0,0,0,0.0,
0,GA Briant (ZIM),1993-1993,1,1,0,0,0,0,0,0,0.0,
1,NT Broom (NZ),2017-2017,2,4,0,0,0,0,0,0,0.0,
2,LS Brown (SA),1931-1932,2,3,0,0,0,0,0,0,0.0,
3,GK Bruk-Jackson (ZIM),1993-1993,2,4,0,0,0,0,0,0,0.0,
4,C Burke (NZ),1946-1946,1,1,0,0,0,0,0,0,0.0,
5,SF Burke (SA),1962-1965,2,4,0,0,0,0,0,0,0.0,
6,EJK Burn (AUS),1890-1890,2,4,0,0,0,0,0,0,0.0,
7,AR Butcher (ENG),1979-1979,1,2,0,0,0,0,0,0,0.0,
8,LS Butler (WI),1955-1955,1,1,0,0,0,0,0,0,0.0,
9,LA Butterfield (NZ),1946-1946,1,1,0,0,0,0,0,0,0.0,
10,ID Buys (SA),1922-1922,1,2,0,0,0,0,0,0,0.0,
11,ST Callaway (AUS),1892-1895,3,6,0,0,0,0,0,0,0.0,
12,FJ Cameron (WI),1948-1949,5,10,0,0,0,0,0,0,0.0,
13,JH Cameron (WI),1939-1939,2,4,0,0,0,0,0,0,0.0,
14,DB Carr (ENG),1951-1952,2,2,0,0,0,0,0,0,0.0,
15,DW Carr (ENG),1909-1909,1,2,0,0,0,0,0,0,0.0,
16,HWR Cartwright (AUS),2017-2017,2,4,0,0,0,0,0,0,0.0,
17,G Challenor (WI),1928-1928,3,3,0,0,0,0,0,0,0.0,
18,HS Chang (WI),1979-1979,1,2,0,0,0,0,0,0,0.0,
19,PC Charlton (AUS),1890-1890,2,4,0,0,0,0,0,0,0.0,
20,HRJ Charlwood (ENG),1877-1877,2,4,0,0,0,0,0,0,0.0,
21,TL Chatara (ZIM),2013-2018,9,17,0,0,0,0,0,0,0.0,
22,W Chatterton (ENG),1892-1892,1,2,0,0,0,0,0,0,0.0,
23,CJ Chibhabha (ZIM),2016-2017,3,4,0,0,0,0,0,0,0.0,
24,MT Chinouya (ZIM),2016-2016,2,3,0,0,0,0,0,0,0.0,
25,N Chopra (INDIA),2000-2000,1,1,0,0,0,0,0,0,0.0,
26,NR Chowdhury (INDIA),1949-1951,2,3,0,0,0,0,0,0,0.0,
27,S Christopherson (ENG),1884-1884,1,2,0,0,0,0,0,0,0.0,
28,GWA Chubb (SA),1951-1951,5,9,0,0,0,0,0,0,0.0,
29,EW Clark (ENG),1929-1934,8,15,0,0,0,0,0,0,0.0,
30,CB Clarke (WI),1939-1939,3,6,0,0,0,0,0,0,0.0,
31,DC Cleverley (NZ),1932-1946,2,2,0,0,0,0,0,0,0.0,
32,JAK Cochran (SA),1931-1931,1,2,0,0,0,0,0,0,0.0,
33,A Coningham (AUS),1894-1895,1,2,0,0,0,0,0,0,0.0,
34,DP Conway (NZ),2021-2022,5,10,0,0,0,0,0,0,0.0,
35,C Cook (ENG),1947-1947,1,2,0,0,0,0,0,0,0.0,
36,FJ Cook (SA),1896-1896,1,2,0,0,0,0,0,0,0.0,
37,SH Cook (AUS),1997-1997,2,4,0,0,0,0,0,0,0.0,
38,SJ Cook (SA),1992-1993,3,5,0,0,0,0,0,0,0.0,
39,GE Corling (AUS),1964-1964,5,8,0,0,0,0,0,0,0.0,
40,SS Cottrell (WI),2013-2014,2,2,0,0,0,0,0,0,0.0,
41,G Coulthard (AUS),1882-1882,1,2,0,0,0,0,0,0,0.0,
42,Hon.CJ Coventry (ENG),1889-1889,2,4,0,0,0,0,0,0,0.0,
43,A Coxon (ENG),1948-1948,1,2,0,0,0,0,0,0,0.0,
44,MS Crane (ENG),2018-2018,1,1,0,0,0,0,0,0,0.0,
45,GF Cresswell (NZ),1949-1951,3,4,0,0,0,0,0,0,0.0,
46,G Cripps (SA),1892-1892,1,1,0,0,0,0,0,0,0.0,
47,GJ Crocker (ZIM),1992-1992,3,5,0,0,0,0,0,0,0.0,
48,DJ Cullen (AUS),2006-2006,1,2,0,0,0,0,0,0,0.0,
49,TK Curran (ENG),2017-2018,2,3,0,0,0,0,0,0,0.0,
0,AC Dale (AUS),1998-1999,2,4,0,0,0,0,0,0,0.0,
1,JW D'Arcy (NZ),1958-1958,5,6,0,0,0,0,0,0,0.0,
2,EQ Davies (SA),1936-1939,5,6,0,0,0,0,0,0,0.0,
3,SP Davis (AUS),1986-1986,1,1,0,0,0,0,0,0,0.0,
4,AC Dawson (SA),2003-2003,2,4,0,0,0,0,0,0,0.0,
5,EW Dawson (ENG),1928-1930,5,8,0,0,0,0,0,0,0.0,
6,Z de Bruyn (SA),2004-2004,3,5,0,0,0,0,0,0,0.0,
7,RP de Groen (NZ),1993-1994,5,7,0,0,0,0,0,0,0.0,
8,AR Dell (AUS),1971-1974,2,4,0,0,0,0,0,0,0.0,
9,GRA de Silva (SL),1982-1982,4,8,0,0,0,0,0,0,0.0,
10,DT Dewdney (WI),1955-1958,9,16,0,0,0,0,0,0,0.0,
11,JG Dewes (ENG),1948-1950,5,8,0,0,0,0,0,0,0.0,
12,AE Dipper (ENG),1921-1921,1,2,0,0,0,0,0,0,0.0,
13,GH Dockrell (IRE),2019-2019,1,2,0,0,0,0,0,0,0.0,
14,RG Draper (SA),1950-1950,2,3,0,0,0,0,0,0,0.0,
15,JRF Duncan (AUS),1971-1971,1,2,0,0,0,0,0,0,0.0,
16,FJ Durston (ENG),1921-1921,1,2,0,0,0,0,0,0,0.0,
17,DV Dyer (SA),1947-1947,3,6,0,0,0,0,0,0,0.0,
18,KH Eastwood (AUS),1971-1971,1,2,0,0,0,0,0,0,0.0,
19,HI Ebeling (AUS),1934-1934,1,2,0,0,0,0,0,0,0.0,
20,RM Edwards (WI),1968-1969,5,9,0,0,0,0,0,0,0.0,
21,WJ Edwards (AUS),1974-1974,3,6,0,0,0,0,0,0,0.0,
22,Ehsanul Haque (BAN),2002-2002,1,1,0,0,0,0,0,0,0.0,
23,Ehsan Adil (PAK),2013-2015,3,5,0,0,0,0,0,0,0.0,
24,RWG Emery (NZ),1952-1952,2,3,0,0,0,0,0,0,0.0,
25,GM Emmett (ENG),1948-1948,1,2,0,0,0,0,0,0,0.0,
26,AJ Evans (ENG),1921-1921,1,2,0,0,0,0,0,0,0.0,
27,Faisal Hossain (BAN),2004-2004,1,2,0,0,0,0,0,0,0.0,
28,Farhan Adil (PAK),2003-2003,1,2,0,0,0,0,0,0,0.0,
29,Farooq Hamid (PAK),1964-1964,1,2,0,0,0,0,0,0,0.0,
30,Farrukh Zaman (PAK),1976-1976,1,2,0,0,0,0,0,0,0.0,
31,JP Faulkner (AUS),2013-2013,1,2,0,0,0,0,0,0,0.0,
32,CJ Ferguson (AUS),2016-2016,1,1,0,0,0,0,0,0,0.0,
33,LH Ferguson (NZ),2019-2019,1,2,0,0,0,0,0,0,0.0,
34,MP Fernandes (WI),1928-1930,2,3,0,0,0,0,0,0,0.0,
35,AM Fernando (SL),2021-2021,3,6,0,0,0,0,0,0,0.0,
36,ERNS Fernando (SL),1983-1984,5,8,0,0,0,0,0,0,0.0,
37,KADM Fernando (SL),2003-2003,2,4,0,0,0,0,0,0,0.0,
38,NR Ferreira (ZIM),2005-2005,1,1,0,0,0,0,0,0,0.0,
39,CE Finlason (SA),1889-1889,1,2,0,0,0,0,0,0,0.0,
40,FE Fisher (NZ),1953-1953,1,1,0,0,0,0,0,0,0.0,
41,JA Flavell (ENG),1961-1964,4,7,0,0,0,0,0,0,0.0,
42,LO Fleetwood-Smith (AUS),1935-1938,10,18,0,0,0,0,0,0,0.0,
43,CE Floquet (SA),1910-1910,1,2,0,0,0,0,0,0,0.0,
44,H Foley (NZ),1930-1930,1,2,0,0,0,0,0,0,0.0,
45,AJ Fothergill (ENG),1889-1889,2,4,0,0,0,0,0,0,0.0,
46,CN Frank (SA),1921-1921,3,6,0,0,0,0,0,0,0.0,
47,WHB Frank (SA),1896-1896,1,1,0,0,0,0,0,0,0.0,
48,MC Frederick (WI),1954-1954,1,2,0,0,0,0,0,0,0.0,
49,DL Freeman (NZ),1933-1933,2,2,0,0,0,0,0,0,0.0,
0,FAW Freer (AUS),1946-1946,1,2,0,0,0,0,0,0,0.0,
1,RL Fuller (WI),1935-1935,1,2,0,0,0,0,0,0,0.0,
2,HA Furlonge (WI),1955-1956,3,5,0,0,0,0,0,0,0.0,
3,HG Gaekwad (INDIA),1952-1952,1,1,0,0,0,0,0,0,0.0,
4,IS Gallage (SL),1999-1999,1,2,0,0,0,0,0,0,0.0,
5,N Gallichan (NZ),1937-1937,1,2,0,0,0,0,0,0,0.0,
6,PLS Gamage (SL),2017-2018,5,9,0,0,0,0,0,0,0.0,
7,D Ganesh (INDIA),1997-1997,4,7,0,0,0,0,0,0,0.0,
8,AG Ganteaume (WI),1948-1948,1,2,0,0,0,0,0,0,0.0,
9,SG Gedye (NZ),1964-1965,4,8,0,0,0,0,0,0,0.0,
10,PR George (AUS),2010-2010,1,2,0,0,0,0,0,0,0.0,
11,MEZ Ghazali (PAK),1954-1954,2,2,0,0,0,0,0,0,0.0,
12,Ghulam Abbas (PAK),1967-1967,1,2,0,0,0,0,0,0,0.0,
13,OD Gibson (WI),1995-1999,2,4,0,0,0,0,0,0,0.0,
14,ESH Giddins (ENG),1999-2000,4,7,0,0,0,0,0,0,0.0,
15,DR Gilbert (AUS),1985-1986,9,13,0,0,0,0,0,0,0.0,
16,SR Gillespie (NZ),1986-1986,1,1,0,0,0,0,0,0,0.0,
17,AHH Gilligan (ENG),1930-1930,4,6,0,0,0,0,0,0,0.0,
18,G Gladstone (WI),1930-1930,1,2,0,0,0,0,0,0,0.0,
19,GK Glover (SA),1896-1896,1,1,0,0,0,0,0,0,0.0,
20,DW Gregory (AUS),1877-1879,3,6,0,0,0,0,0,0,0.0,
21,IA Greig (ENG),1982-1982,2,4,0,0,0,0,0,0,0.0,
22,BAF Grieve (ENG),1889-1889,2,4,0,0,0,0,0,0,0.0,
23,GM Griffin (SA),1960-1960,2,3,0,0,0,0,0,0,0.0,
24,TU Groube (AUS),1880-1880,1,2,0,0,0,0,0,0,0.0,
25,CEJ Guest (AUS),1963-1963,1,2,0,0,0,0,0,0,0.0,
26,RPW Guneratne (SL),1983-1983,1,1,0,0,0,0,0,0,0.0,
27,BP Gupte (INDIA),1961-1965,3,5,0,0,0,0,0,0,0.0,
28,A Habib (ENG),1999-1999,2,4,0,0,0,0,0,0,0.0,
29,GG Hall (SA),1965-1965,1,2,0,0,0,0,0,0,0.0,
30,C Hallows (ENG),1921-1928,2,3,0,0,0,0,0,0,0.0,
31,GM Hamilton (ENG),1999-1999,1,1,0,0,0,0,0,0,0.0,
32,RHM Hands (SA),1914-1914,1,2,0,0,0,0,0,0,0.0,
33,MA Hanley (SA),1949-1949,1,2,0,0,0,0,0,0,0.0,
34,HTW Hardinge (ENG),1921-1921,1,2,0,0,0,0,0,0,0.0,
35,NS Harford (NZ),1955-1958,8,11,0,0,0,0,0,0,0.0,
36,RM Harris (NZ),1959-1959,2,2,0,0,0,0,0,0,0.0,
37,GPD Hartigan (SA),1912-1914,5,6,0,0,0,0,0,0,0.0,
38,AEV Hartkopf (AUS),1925-1925,1,2,0,0,0,0,0,0,0.0,
39,MR Harvey (AUS),1947-1947,1,2,0,0,0,0,0,0,0.0,
40,RL Harvey (SA),1936-1936,2,2,0,0,0,0,0,0,0.0,
41,Harvinder Singh (INDIA),1998-2001,3,6,0,0,0,0,0,0,0.0,
42,GG Hearne (ENG),1892-1892,1,2,0,0,0,0,0,0,0.0,
43,BE Hendricks (SA),2020-2020,1,2,0,0,0,0,0,0,0.0,
44,D Hettiarachchi (SL),2001-2001,1,2,0,0,0,0,0,0,0.0,
45,CFW Hime (SA),1896-1896,1,2,0,0,0,0,0,0,0.0,
46,JR Hodges (AUS),1877-1877,2,4,0,0,0,0,0,0,0.0,
47,CK Holder (WI),2020-2020,1,1,0,0,0,0,0,0,0.0,
48,JL Hopwood (ENG),1934-1934,2,3,0,0,0,0,0,0,0.0,
49,AN Hornby (ENG),1879-1884,3,5,0,0,0,0,0,0,0.0,
0,AB Howard (WI),1972-1972,1,1,0,0,0,0,0,0,0.0,
1,H Howell (ENG),1920-1924,5,8,0,0,0,0,0,0,0.0,
2,Humayun Farhat (PAK),2001-2001,1,1,0,0,0,0,0,0,0.0,
3,KC Ibrahim (INDIA),1948-1949,4,6,0,0,0,0,0,0,0.0,
4,J Iddon (ENG),1935-1935,5,9,0,0,0,0,0,0,0.0,
5,Iftikhar Anjum (PAK),2006-2006,1,2,0,0,0,0,0,0,0.0,
6,Ijaz Faqih (PAK),1980-1988,5,8,0,0,0,0,0,0,0.0,
7,MC Ilott (ENG),1993-1995,5,8,0,0,0,0,0,0,0.0,
8,Imran Khan (PAK),2014-2019,10,19,0,0,0,0,0,0,0.0,
9,PJ Ingram (NZ),2010-2010,2,4,0,0,0,0,0,0,0.0,
10,RD Jackman (ENG),1981-1982,4,7,0,0,0,0,0,0,0.0,
11,AS Jaggernauth (WI),2008-2008,1,2,0,0,0,0,0,0,0.0,
12,LP Jai (INDIA),1933-1933,1,2,0,0,0,0,0,0,0.0,
13,Jalal-ud-Din (PAK),1982-1985,6,9,0,0,0,0,0,0,0.0,
14,SP James (ENG),1998-1998,2,4,0,0,0,0,0,0,0.0,
15,JA Jameson (ENG),1971-1974,4,6,0,0,0,0,0,0,0.0,
16,Javed Akhtar (PAK),1962-1962,1,1,0,0,0,0,0,0,0.0,
17,HK Jayantilal (INDIA),1971-1971,1,2,0,0,0,0,0,0,0.0,
18,RSA Jayasekera (SL),1982-1982,1,1,0,0,0,0,0,0,0.0,
19,P Jayawickrama (SL),2021-2021,3,6,0,0,0,0,0,0,0.0,
20,S Jeganathan (SL),1983-1983,2,3,0,0,0,0,0,0,0.0,
21,DJ Johnson (INDIA),1996-1996,2,4,0,0,0,0,0,0,0.0,
22,HHH Johnson (WI),1948-1950,3,6,0,0,0,0,0,0,0.0,
23,RL Johnson (ENG),2003-2003,3,6,0,0,0,0,0,0,0.0,
24,RA Jones (NZ),2003-2003,1,2,0,0,0,0,0,0,0.0,
25,LM Jongwe (ZIM),2021-2021,1,1,0,0,0,0,0,0,0.0,
26,LR Joslin (AUS),1968-1968,1,2,0,0,0,0,0,0,0.0,
27,T Kaitano (ZIM),2021-2021,1,2,0,0,0,0,0,0,0.0,
28,Kamrul Islam Rabbi (BAN),2016-2018,7,13,0,0,0,0,0,0,0.0,
29,TP Kamungozi (ZIM),2014-2014,1,2,0,0,0,0,0,0,0.0,
30,TE Kane (IRE),2018-2018,1,2,0,0,0,0,0,0,0.0,
31,HH Kanitkar (INDIA),1999-2000,2,3,0,0,0,0,0,0,0.0,
32,HS Kanitkar (INDIA),1974-1974,2,3,0,0,0,0,0,0,0.0,
33,WW Keeton (ENG),1934-1939,2,2,0,0,0,0,0,0,0.0,
34,GA Kempis (SA),1889-1889,1,2,0,0,0,0,0,0,0.0,
35,SC Kerrigan (ENG),2013-2013,1,2,0,0,0,0,0,0,0.0,
36,Khalid Hasan (PAK),1954-1954,1,1,0,0,0,0,0,0,0.0,
37,Khalid Wazir (PAK),1954-1954,2,2,0,0,0,0,0,0,0.0,
38,A Khan (ENG),2009-2009,1,2,0,0,0,0,0,0,0.0,
39,JH King (ENG),1909-1909,1,2,0,0,0,0,0,0,0.0,
40,SP Kinneir (ENG),1911-1911,1,2,0,0,0,0,0,0,0.0,
41,NA Knox (ENG),1907-1907,2,4,0,0,0,0,0,0,0.0,
42,CKB Kulasekara (SL),2011-2011,1,2,0,0,0,0,0,0,0.0,
43,UN Kulkarni (INDIA),1967-1968,4,8,0,0,0,0,0,0,0.0,
44,AK Kuruppuarachchi (SL),1986-1987,2,3,0,0,0,0,0,0,0.0,
45,A Kuruvilla (INDIA),1997-1997,10,15,0,0,0,0,0,0,0.0,
46,F Kuys (SA),1899-1899,1,2,0,0,0,0,0,0,0.0,
47,MN Lathwell (ENG),1993-1993,2,3,0,0,0,0,0,0,0.0,
48,DV Lawrence (ENG),1988-1992,5,10,0,0,0,0,0,0,0.0,
49,HW Lee (ENG),1931-1931,1,2,0,0,0,0,0,0,0.0,
0,JG Leggat (NZ),1952-1956,9,10,0,0,0,0,0,0,0.0,
1,FL le Roux (SA),1914-1914,1,2,0,0,0,0,0,0,0.0,
2,AR Lewis (ENG),1972-1973,9,17,0,0,0,0,0,0,0.0,
3,J Lewis (ENG),2006-2006,1,2,0,0,0,0,0,0,0.0,
4,PT Lewis (SA),1913-1913,1,1,0,0,0,0,0,0,0.0,
5,RN Lewis (WI),1997-2008,5,9,0,0,0,0,0,0,0.0,
6,GF Linde (SA),2019-2021,3,5,0,0,0,0,0,0,0.0,
7,DK Liyanage (SL),1992-2001,9,15,0,0,0,0,0,0,0.0,
8,TA Lloyd (ENG),1984-1984,1,1,0,0,0,0,0,0,0.0,
9,ACI Lock (ZIM),1995-1995,1,2,0,0,0,0,0,0,0.0,
10,GR Loveridge (NZ),1996-1996,1,2,0,0,0,0,0,0,0.0,
11,EB Lundie (SA),1914-1914,1,2,0,0,0,0,0,0,0.0,
12,MJ Macaulay (SA),1965-1965,1,2,0,0,0,0,0,0,0.0,
13,AR McBrine (IRE),2019-2019,2,4,0,0,0,0,0,0,0.0,
14,JCW MacBryan (ENG),1924-1924,1,1,0,0,0,0,0,0,0.0,
15,BE McGain (AUS),2009-2009,1,1,0,0,0,0,0,0,0.0,
16,HM McGirr (NZ),1930-1930,2,3,0,0,0,0,0,0,0.0,
17,PE McIntyre (AUS),1995-1996,2,4,0,0,0,0,0,0,0.0,
18,AJ McKay (NZ),2010-2010,1,1,0,0,0,0,0,0,0.0,
19,FA MacKinnon (ENG),1879-1879,1,2,0,0,0,0,0,0,0.0,
20,JW McLaren (AUS),1912-1912,1,2,0,0,0,0,0,0,0.0,
21,R McLaren (SA),2010-2014,2,4,0,0,0,0,0,0,0.0,
22,EG McLeod (NZ),1930-1930,1,2,0,0,0,0,0,0,0.0,
23,JEP McMaster (ENG),1889-1889,1,2,0,0,0,0,0,0,0.0,
24,DAN McRae (NZ),1946-1946,1,1,0,0,0,0,0,0,0.0,
25,MAWR Madurasinghe (SL),1988-1992,3,5,0,0,0,0,0,0,0.0,
26,Mahbubul Alam (BAN),2008-2008,4,6,0,0,0,0,0,0,0.0,
27,SI Mahmood (ENG),2006-2007,8,14,0,0,0,0,0,0,0.0,
28,Mahmudul Hasan Joy (BAN),2021-2022,2,3,0,0,0,0,0,0,0.0,
29,JWH Makepeace (ENG),1920-1921,4,7,0,0,0,0,0,0,0.0,
30,NA Mallender (ENG),1992-1992,2,4,0,0,0,0,0,0,0.0,
31,MF Malone (AUS),1977-1977,1,2,0,0,0,0,0,0,0.0,
32,LA Markham (SA),1949-1949,1,2,0,0,0,0,0,0,0.0,
33,VJ Marks (ENG),1982-1984,6,12,0,0,0,0,0,0,0.0,
34,AP Marr (AUS),1885-1885,1,2,0,0,0,0,0,0,0.0,
35,NE Marshall (WI),1955-1955,1,2,0,0,0,0,0,0,0.0,
36,BP Martin (NZ),2013-2013,5,9,0,0,0,0,0,0,0.0,
37,JW Martin (ENG),1947-1947,1,2,0,0,0,0,0,0,0.0,
38,WFE Marx (SA),1921-1921,3,6,0,0,0,0,0,0,0.0,
39,MJ Mason (NZ),2004-2004,1,2,0,0,0,0,0,0,0.0,
40,Masood Anwar (PAK),1990-1990,1,2,0,0,0,0,0,0,0.0,
41,EZ Matambanadzo (ZIM),1996-1999,3,6,0,0,0,0,0,0,0.0,
42,T Meale (NZ),1958-1958,2,3,0,0,0,0,0,0,0.0,
43,JM Mennie (AUS),2016-2016,1,1,0,0,0,0,0,0,0.0,
44,KO Meth (ZIM),2013-2013,2,4,0,0,0,0,0,0,0.0,
45,EM Meuli (NZ),1953-1953,1,1,0,0,0,0,0,0,0.0,
46,AM Miller (ENG),1896-1896,1,2,0,0,0,0,0,0,0.0,
47,NO Miller (WI),2009-2009,1,2,0,0,0,0,0,0,0.0,
48,RC Miller (WI),1953-1953,1,2,0,0,0,0,0,0,0.0,
49,RB Minnett (AUS),1911-1912,9,16,0,0,0,0,0,0,0.0,
0,Miran Bakhsh (PAK),1955-1955,2,4,0,0,0,0,0,0,0.0,
1,SF Mire (ZIM),2017-2017,2,3,0,0,0,0,0,0,0.0,
2,Mir Hamza (PAK),2018-2018,1,2,0,0,0,0,0,0,0.0,
3,NS Mitchell-Innes (ENG),1935-1935,1,2,0,0,0,0,0,0,0.0,
4,A Mithun (INDIA),2010-2011,4,8,0,0,0,0,0,0,0.0,
5,Mohammad Aslam (PAK),1954-1954,1,1,0,0,0,0,0,0,0.0,
6,Mohammad Irfan (PAK),2013-2013,4,6,0,0,0,0,0,0,0.0,
7,Mohammad Khalil (PAK),2004-2005,2,4,0,0,0,0,0,0,0.0,
8,Mohammad Munaf (PAK),1959-1962,4,8,0,0,0,0,0,0,0.0,
9,Mohammad Shahid (BAN),2015-2015,5,6,0,0,0,0,0,0,0.0,
10,Mohammad Shahzad (AFG),2018-2019,2,3,0,0,0,0,0,0,0.0,
11,Mohammad Zahid (PAK),1996-2003,5,9,0,0,0,0,0,0,0.0,
12,DS Mohanty (INDIA),1997-1997,2,4,0,0,0,0,0,0,0.0,
13,JA Morkel (SA),2009-2009,1,2,0,0,0,0,0,0,0.0,
14,J Moroney (AUS),1949-1952,7,13,0,0,0,0,0,0,0.0,
15,S Morris (AUS),1885-1885,1,2,0,0,0,0,0,0,0.0,
16,JK Moss (AUS),1979-1979,1,2,0,0,0,0,0,0,0.0,
17,VM Muddiah (INDIA),1959-1960,2,3,0,0,0,0,0,0,0.0,
18,GH Mudie (WI),1935-1935,1,2,0,0,0,0,0,0,0.0,
19,BS Mudzinganyama (ZIM),2020-2020,1,2,0,0,0,0,0,0,0.0,
20,Muhammad Musa (PAK),2019-2019,1,1,0,0,0,0,0,0,0.0,
21,Mujeeb Ur Rahman (AFG),2018-2018,1,1,0,0,0,0,0,0,0.0,
22,Munir Ahmad (AFG),2021-2021,1,2,0,0,0,0,0,0,0.0,
23,C Munro (NZ),2013-2013,1,1,0,0,0,0,0,0,0.0,
24,TA Munton (ENG),1992-1992,2,4,0,0,0,0,0,0,0.0,
25,T Mupariwa (ZIM),2004-2004,1,1,0,0,0,0,0,0,0.0,
26,TJ Murtagh (IRE),2018-2019,3,6,0,0,0,0,0,0,0.0,
27,HA Musgrove (AUS),1885-1885,1,2,0,0,0,0,0,0,0.0,
28,DT Mutendera (ZIM),2000-2000,1,2,0,0,0,0,0,0,0.0,
29,F Mutizwa (ZIM),2012-2012,1,1,0,0,0,0,0,0,0.0,
30,B Muzarabani (ZIM),2017-2021,6,9,0,0,0,0,0,0,0.0,
31,W Mwayenga (ZIM),2005-2005,1,2,0,0,0,0,0,0,0.0,
32,Nadeem Ghauri (PAK),1990-1990,1,1,0,0,0,0,0,0,0.0,
33,Nadeem Khan (PAK),1993-1999,2,4,0,0,0,0,0,0,0.0,
34,LE Nagel (AUS),1932-1932,1,2,0,0,0,0,0,0,0.0,
35,SS Naik (INDIA),1974-1975,3,4,0,0,0,0,0,0,0.0,
36,Naoomal Jaoomal (INDIA),1932-1934,3,6,0,0,0,0,0,0,0.0,
37,T Natarajan (INDIA),2021-2021,1,2,0,0,0,0,0,0,0.0,
38,Nauman Ali (PAK),2021-2021,7,14,0,0,0,0,0,0,0.0,
39,Naved Anjum (PAK),1989-1990,2,4,0,0,0,0,0,0,0.0,
40,Naved Ashraf (PAK),1998-2000,2,4,0,0,0,0,0,0,0.0,
41,Naved Latif (PAK),2002-2002,1,2,0,0,0,0,0,0,0.0,
42,MN Nawaz (SL),2002-2002,1,2,0,0,0,0,0,0,0.0,
43,S Nazir Ali (INDIA),1932-1934,2,4,0,0,0,0,0,0,0.0,
44,Nazmul Hossain (BAN),2004-2011,2,3,0,0,0,0,0,0,0.0,
45,Nazmul Islam (BAN),2018-2018,1,2,0,0,0,0,0,0,0.0,
46,JM Neblett (WI),1935-1935,1,2,0,0,0,0,0,0,0.0,
47,MG Neser (AUS),2021-2021,1,2,0,0,0,0,0,0,0.0,
48,W Newham (ENG),1888-1888,1,2,0,0,0,0,0,0,0.0,
49,J Newman (NZ),1932-1933,3,3,0,0,0,0,0,0,0.0,
